PokerStars Hand #245446274018: Tournament #3632677041, $0.23+$0.02 USD Hold'em No Limit - Level I (10/20) - 2023/08/17 17:23:55 AT [2023/08/17 16:23:55 ET]
Table '3632677041 3' 9-max Seat #1 is the button
Seat 1: INISHTE (1500 in chips) 
Seat 3: zulus47 (1500 in chips) 
Seat 4: PETROSOO42 (1500 in chips) 
Seat 5: rekisser85 (1500 in chips) 
Seat 6: Caio Mugarte (1500 in chips) 
Seat 7: LuffyThePirateK (1500 in chips) 
Seat 8: Cheburah007 (1500 in chips) 
Seat 9: J_d1nAlt (1500 in chips) 
INISHTE: posts the ante 3
zulus47: posts the ante 3
PETROSOO42: posts the ante 3
rekisser85: posts the ante 3
Caio Mugarte: posts the ante 3
LuffyThePirateK: posts the ante 3
Cheburah007: posts the ante 3
J_d1nAlt: posts the ante 3
zulus47: posts small blind 10
PETROSOO42: posts big blind 20
*** HOLE CARDS ***
Dealt to Caio Mugarte [2c 5c]
rekisser85: folds 
Caio Mugarte: folds 
LuffyThePirateK: folds 
Cheburah007: folds 
J_d1nAlt: raises 20 to 40
INISHTE: folds 
zulus47: folds 
PETROSOO42: calls 20
*** FLOP *** [6c 6h 2d]
PETROSOO42: bets 20
J_d1nAlt: calls 20
*** TURN *** [6c 6h 2d] [7d]
PETROSOO42: checks 
J_d1nAlt: checks 
*** RIVER *** [6c 6h 2d 7d] [9c]
PETROSOO42: checks 
J_d1nAlt: checks 
*** SHOW DOWN ***
PETROSOO42: shows [4h 2s] (two pair, Sixes and Deuces)
J_d1nAlt: mucks hand 
PETROSOO42 collected 154 from pot
*** SUMMARY ***
Total pot 154 | Rake 0 
Board [6c 6h 2d 7d 9c]
Seat 1: INISHTE (button) folded before Flop (didn't bet)
Seat 3: zulus47 (small blind) folded before Flop
Seat 4: PETROSOO42 (big blind) showed [4h 2s] and won (154) with two pair, Sixes and Deuces
Seat 5: rekisser85 folded before Flop (didn't bet)
Seat 6: Caio Mugarte folded before Flop (didn't bet)
Seat 7: LuffyThePirateK folded before Flop (didn't bet)
Seat 8: Cheburah007 folded before Flop (didn't bet)
Seat 9: J_d1nAlt mucked [As Th]



PokerStars Hand #245446287024: Tournament #3632677041, $0.23+$0.02 USD Hold'em No Limit - Level I (10/20) - 2023/08/17 17:24:32 AT [2023/08/17 16:24:32 ET]
Table '3632677041 3' 9-max Seat #3 is the button
Seat 1: INISHTE (1497 in chips) 
Seat 3: zulus47 (1487 in chips) 
Seat 4: PETROSOO42 (1591 in chips) 
Seat 5: rekisser85 (1497 in chips) 
Seat 6: Caio Mugarte (1497 in chips) 
Seat 7: LuffyThePirateK (1497 in chips) 
Seat 8: Cheburah007 (1497 in chips) 
Seat 9: J_d1nAlt (1437 in chips) 
INISHTE: posts the ante 3
zulus47: posts the ante 3
PETROSOO42: posts the ante 3
rekisser85: posts the ante 3
Caio Mugarte: posts the ante 3
LuffyThePirateK: posts the ante 3
Cheburah007: posts the ante 3
J_d1nAlt: posts the ante 3
PETROSOO42: posts small blind 10
rekisser85: posts big blind 20
*** HOLE CARDS ***
Dealt to Caio Mugarte [Ts 5d]
Caio Mugarte: folds 
LuffyThePirateK: folds 
Cheburah007: raises 40 to 60
J_d1nAlt: folds 
INISHTE: folds 
zulus47: folds 
PETROSOO42: folds 
rekisser85: folds 
Uncalled bet (40) returned to Cheburah007
Cheburah007 collected 74 from pot
Cheburah007: doesn't show hand 
*** SUMMARY ***
Total pot 74 | Rake 0 
Seat 1: INISHTE folded before Flop (didn't bet)
Seat 3: zulus47 (button) folded before Flop (didn't bet)
Seat 4: PETROSOO42 (small blind) folded before Flop
Seat 5: rekisser85 (big blind) folded before Flop
Seat 6: Caio Mugarte folded before Flop (didn't bet)
Seat 7: LuffyThePirateK folded before Flop (didn't bet)
Seat 8: Cheburah007 collected (74)
Seat 9: J_d1nAlt folded before Flop (didn't bet)



PokerStars Hand #245446295450: Tournament #3632677041, $0.23+$0.02 USD Hold'em No Limit - Level I (10/20) - 2023/08/17 17:24:56 AT [2023/08/17 16:24:56 ET]
Table '3632677041 3' 9-max Seat #4 is the button
Seat 1: INISHTE (1494 in chips) 
Seat 3: zulus47 (1484 in chips) 
Seat 4: PETROSOO42 (1578 in chips) 
Seat 5: rekisser85 (1474 in chips) 
Seat 6: Caio Mugarte (1494 in chips) 
Seat 7: LuffyThePirateK (1494 in chips) 
Seat 8: Cheburah007 (1548 in chips) 
Seat 9: J_d1nAlt (1434 in chips) 
INISHTE: posts the ante 3
zulus47: posts the ante 3
PETROSOO42: posts the ante 3
rekisser85: posts the ante 3
Caio Mugarte: posts the ante 3
LuffyThePirateK: posts the ante 3
Cheburah007: posts the ante 3
J_d1nAlt: posts the ante 3
rekisser85: posts small blind 10
Caio Mugarte: posts big blind 20
*** HOLE CARDS ***
Dealt to Caio Mugarte [8h Ks]
LuffyThePirateK: folds 
Cheburah007: folds 
J_d1nAlt: raises 20 to 40
INISHTE: folds 
zulus47: folds 
PETROSOO42: calls 40
rekisser85: folds 
Caio Mugarte: folds 
*** FLOP *** [Ts 3s 6c]
J_d1nAlt: checks 
PETROSOO42: checks 
*** TURN *** [Ts 3s 6c] [Jh]
J_d1nAlt: checks 
PETROSOO42: checks 
*** RIVER *** [Ts 3s 6c Jh] [8c]
J_d1nAlt: bets 134
PETROSOO42: calls 134
*** SHOW DOWN ***
J_d1nAlt: shows [Kc Jd] (a pair of Jacks)
PETROSOO42: mucks hand 
J_d1nAlt collected 402 from pot
*** SUMMARY ***
Total pot 402 | Rake 0 
Board [Ts 3s 6c Jh 8c]
Seat 1: INISHTE folded before Flop (didn't bet)
Seat 3: zulus47 folded before Flop (didn't bet)
Seat 4: PETROSOO42 (button) mucked [8d 7d]
Seat 5: rekisser85 (small blind) folded before Flop
Seat 6: Caio Mugarte (big blind) folded before Flop
Seat 7: LuffyThePirateK folded before Flop (didn't bet)
Seat 8: Cheburah007 folded before Flop (didn't bet)
Seat 9: J_d1nAlt showed [Kc Jd] and won (402) with a pair of Jacks



PokerStars Hand #245446306979: Tournament #3632677041, $0.23+$0.02 USD Hold'em No Limit - Level I (10/20) - 2023/08/17 17:25:30 AT [2023/08/17 16:25:30 ET]
Table '3632677041 3' 9-max Seat #5 is the button
Seat 1: INISHTE (1491 in chips) 
Seat 3: zulus47 (1481 in chips) 
Seat 4: PETROSOO42 (1401 in chips) 
Seat 5: rekisser85 (1461 in chips) 
Seat 6: Caio Mugarte (1471 in chips) 
Seat 7: LuffyThePirateK (1491 in chips) 
Seat 8: Cheburah007 (1545 in chips) 
Seat 9: J_d1nAlt (1659 in chips) 
INISHTE: posts the ante 3
zulus47: posts the ante 3
PETROSOO42: posts the ante 3
rekisser85: posts the ante 3
Caio Mugarte: posts the ante 3
LuffyThePirateK: posts the ante 3
Cheburah007: posts the ante 3
J_d1nAlt: posts the ante 3
Caio Mugarte: posts small blind 10
LuffyThePirateK: posts big blind 20
*** HOLE CARDS ***
Dealt to Caio Mugarte [8d Kd]
Cheburah007: folds 
J_d1nAlt: calls 20
frogz69 is disconnected 
INISHTE: calls 20
zulus47: calls 20
PETROSOO42: calls 20
rekisser85: calls 20
Caio Mugarte: folds 
LuffyThePirateK: checks 
*** FLOP *** [9s Qc 4d]
LuffyThePirateK: checks 
J_d1nAlt: checks 
INISHTE: checks 
zulus47: checks 
PETROSOO42: checks 
rekisser85: checks 
*** TURN *** [9s Qc 4d] [7h]
LuffyThePirateK: checks 
J_d1nAlt: checks 
INISHTE: checks 
zulus47: checks 
PETROSOO42: checks 
rekisser85: checks 
*** RIVER *** [9s Qc 4d 7h] [3c]
LuffyThePirateK: checks 
J_d1nAlt: checks 
INISHTE: checks 
zulus47: checks 
PETROSOO42: checks 
rekisser85: checks 
*** SHOW DOWN ***
LuffyThePirateK: shows [Ad 5h] (high card Ace)
J_d1nAlt: shows [7d Ah] (a pair of Sevens)
INISHTE: shows [8c 9c] (a pair of Nines)
zulus47: mucks hand 
PETROSOO42: mucks hand 
rekisser85: mucks hand 
INISHTE collected 154 from pot
*** SUMMARY ***
Total pot 154 | Rake 0 
Board [9s Qc 4d 7h 3c]
Seat 1: INISHTE showed [8c 9c] and won (154) with a pair of Nines
Seat 3: zulus47 mucked [Th Jh]
Seat 4: PETROSOO42 mucked [Js Kc]
Seat 5: rekisser85 (button) mucked [5s 5c]
Seat 6: Caio Mugarte (small blind) folded before Flop
Seat 7: LuffyThePirateK (big blind) showed [Ad 5h] and lost with high card Ace
Seat 8: Cheburah007 folded before Flop (didn't bet)
Seat 9: J_d1nAlt showed [7d Ah] and lost with a pair of Sevens



PokerStars Hand #245446340296: Tournament #3632677041, $0.23+$0.02 USD Hold'em No Limit - Level I (10/20) - 2023/08/17 17:27:05 AT [2023/08/17 16:27:05 ET]
Table '3632677041 3' 9-max Seat #6 is the button
Seat 1: INISHTE (1622 in chips) 
Seat 2: frogz69 (1500 in chips) 
Seat 4: PETROSOO42 (1378 in chips) 
Seat 5: rekisser85 (1438 in chips) 
Seat 6: Caio Mugarte (1458 in chips) 
Seat 7: LuffyThePirateK (1468 in chips) 
Seat 8: Cheburah007 (1542 in chips) 
Seat 9: J_d1nAlt (1636 in chips) 
INISHTE: posts the ante 3
frogz69: posts the ante 3
PETROSOO42: posts the ante 3
rekisser85: posts the ante 3
Caio Mugarte: posts the ante 3
LuffyThePirateK: posts the ante 3
Cheburah007: posts the ante 3
J_d1nAlt: posts the ante 3
LuffyThePirateK: posts small blind 10
Cheburah007: posts big blind 20
*** HOLE CARDS ***
Dealt to Caio Mugarte [3h 2d]
J_d1nAlt: calls 20
INISHTE: folds 
frogz69: folds 
PETROSOO42: calls 20
rekisser85: folds 
Caio Mugarte: folds 
LuffyThePirateK: folds 
Cheburah007: checks 
*** FLOP *** [Kh 3s 6c]
Cheburah007: checks 
J_d1nAlt: checks 
PETROSOO42: checks 
*** TURN *** [Kh 3s 6c] [Ac]
Cheburah007: checks 
J_d1nAlt: checks 
PETROSOO42: checks 
*** RIVER *** [Kh 3s 6c Ac] [8c]
Cheburah007: checks 
J_d1nAlt: checks 
PETROSOO42: checks 
*** SHOW DOWN ***
Cheburah007: shows [7h 5c] (high card Ace)
J_d1nAlt: shows [4h 8h] (a pair of Eights)
PETROSOO42: mucks hand 
J_d1nAlt collected 94 from pot
*** SUMMARY ***
Total pot 94 | Rake 0 
Board [Kh 3s 6c Ac 8c]
Seat 1: INISHTE folded before Flop (didn't bet)
Seat 2: frogz69 folded before Flop (didn't bet)
Seat 4: PETROSOO42 mucked [9h Ts]
Seat 5: rekisser85 folded before Flop (didn't bet)
Seat 6: Caio Mugarte (button) folded before Flop (didn't bet)
Seat 7: LuffyThePirateK (small blind) folded before Flop
Seat 8: Cheburah007 (big blind) showed [7h 5c] and lost with high card Ace
Seat 9: J_d1nAlt showed [4h 8h] and won (94) with a pair of Eights



PokerStars Hand #245446357959: Tournament #3632677041, $0.23+$0.02 USD Hold'em No Limit - Level I (10/20) - 2023/08/17 17:27:56 AT [2023/08/17 16:27:56 ET]
Table '3632677041 3' 9-max Seat #7 is the button
Seat 1: INISHTE (1619 in chips) 
Seat 2: frogz69 (1497 in chips) 
Seat 3: n00btimer (1500 in chips) 
Seat 4: PETROSOO42 (1355 in chips) 
Seat 5: rekisser85 (1435 in chips) 
Seat 6: Caio Mugarte (1455 in chips) 
Seat 7: LuffyThePirateK (1455 in chips) 
Seat 8: Cheburah007 (1519 in chips) 
Seat 9: J_d1nAlt (1707 in chips) 
INISHTE: posts the ante 3
frogz69: posts the ante 3
n00btimer: posts the ante 3
PETROSOO42: posts the ante 3
rekisser85: posts the ante 3
Caio Mugarte: posts the ante 3
LuffyThePirateK: posts the ante 3
Cheburah007: posts the ante 3
J_d1nAlt: posts the ante 3
Cheburah007: posts small blind 10
J_d1nAlt: posts big blind 20
*** HOLE CARDS ***
Dealt to Caio Mugarte [4c 4d]
n00btimer is disconnected 
INISHTE: folds 
frogz69: folds 
n00btimer: folds 
PETROSOO42: calls 20
rekisser85: folds 
Caio Mugarte: calls 20
LuffyThePirateK: raises 20 to 40
Cheburah007: calls 30
J_d1nAlt: calls 20
PETROSOO42: calls 20
Caio Mugarte: calls 20
*** FLOP *** [4s Qc Ac]
Cheburah007: checks 
J_d1nAlt: checks 
PETROSOO42: checks 
Caio Mugarte: bets 120
LuffyThePirateK: calls 120
Cheburah007: folds 
J_d1nAlt: folds 
PETROSOO42: folds 
*** TURN *** [4s Qc Ac] [7s]
Caio Mugarte: bets 280
LuffyThePirateK: calls 280
*** RIVER *** [4s Qc Ac 7s] [Th]
Caio Mugarte: bets 1012 and is all-in
LuffyThePirateK: calls 1012 and is all-in
*** SHOW DOWN ***
Caio Mugarte: shows [4c 4d] (three of a kind, Fours)
LuffyThePirateK: shows [Qh Ad] (two pair, Aces and Queens)
Caio Mugarte collected 3051 from pot
LuffyThePirateK finished the tournament
*** SUMMARY ***
Total pot 3051 | Rake 0 
Board [4s Qc Ac 7s Th]
Seat 1: INISHTE folded before Flop (didn't bet)
Seat 2: frogz69 folded before Flop (didn't bet)
Seat 3: n00btimer folded before Flop (didn't bet)
Seat 4: PETROSOO42 folded on the Flop
Seat 5: rekisser85 folded before Flop (didn't bet)
Seat 6: Caio Mugarte showed [4c 4d] and won (3051) with three of a kind, Fours
Seat 7: LuffyThePirateK (button) showed [Qh Ad] and lost with two pair, Aces and Queens
Seat 8: Cheburah007 (small blind) folded on the Flop
Seat 9: J_d1nAlt (big blind) folded on the Flop



PokerStars Hand #245446384484: Tournament #3632677041, $0.23+$0.02 USD Hold'em No Limit - Level I (10/20) - 2023/08/17 17:29:12 AT [2023/08/17 16:29:12 ET]
Table '3632677041 3' 9-max Seat #8 is the button
Seat 1: INISHTE (1616 in chips) 
Seat 2: frogz69 (1494 in chips) 
Seat 3: n00btimer (1497 in chips) 
Seat 4: PETROSOO42 (1312 in chips) 
Seat 5: rekisser85 (1432 in chips) 
Seat 6: Caio Mugarte (3051 in chips) 
Seat 8: Cheburah007 (1476 in chips) 
Seat 9: J_d1nAlt (1664 in chips) 
INISHTE: posts the ante 3
frogz69: posts the ante 3
n00btimer: posts the ante 3
PETROSOO42: posts the ante 3
rekisser85: posts the ante 3
Caio Mugarte: posts the ante 3
Cheburah007: posts the ante 3
J_d1nAlt: posts the ante 3
J_d1nAlt: posts small blind 10
INISHTE: posts big blind 20
*** HOLE CARDS ***
Dealt to Caio Mugarte [Qd 7h]
frogz69: folds 
n00btimer: folds 
PETROSOO42: calls 20
rekisser85: folds 
Caio Mugarte: folds 
Cheburah007: folds 
J_d1nAlt: raises 40 to 60
INISHTE: calls 40
PETROSOO42: calls 40
*** FLOP *** [4c Jh 3d]
J_d1nAlt: bets 102
INISHTE: calls 102
PETROSOO42: folds 
*** TURN *** [4c Jh 3d] [Qc]
J_d1nAlt: bets 204
INISHTE: folds 
Uncalled bet (204) returned to J_d1nAlt
J_d1nAlt collected 408 from pot
*** SUMMARY ***
Total pot 408 | Rake 0 
Board [4c Jh 3d Qc]
Seat 1: INISHTE (big blind) folded on the Turn
Seat 2: frogz69 folded before Flop (didn't bet)
Seat 3: n00btimer folded before Flop (didn't bet)
Seat 4: PETROSOO42 folded on the Flop
Seat 5: rekisser85 folded before Flop (didn't bet)
Seat 6: Caio Mugarte folded before Flop (didn't bet)
Seat 8: Cheburah007 (button) folded before Flop (didn't bet)
Seat 9: J_d1nAlt (small blind) collected (408)



PokerStars Hand #245446405499: Tournament #3632677041, $0.23+$0.02 USD Hold'em No Limit - Level I (10/20) - 2023/08/17 17:30:13 AT [2023/08/17 16:30:13 ET]
Table '3632677041 3' 9-max Seat #9 is the button
Seat 1: INISHTE (1451 in chips) 
Seat 2: frogz69 (1491 in chips) 
Seat 3: n00btimer (1494 in chips) 
Seat 4: PETROSOO42 (1249 in chips) 
Seat 5: rekisser85 (1429 in chips) 
Seat 6: Caio Mugarte (3048 in chips) 
Seat 7: nicolas_vm11 (1500 in chips) 
Seat 8: Cheburah007 (1473 in chips) 
Seat 9: J_d1nAlt (1907 in chips) 
INISHTE: posts the ante 3
frogz69: posts the ante 3
n00btimer: posts the ante 3
PETROSOO42: posts the ante 3
rekisser85: posts the ante 3
Caio Mugarte: posts the ante 3
nicolas_vm11: posts the ante 3
Cheburah007: posts the ante 3
J_d1nAlt: posts the ante 3
INISHTE: posts small blind 10
frogz69: posts big blind 20
*** HOLE CARDS ***
Dealt to Caio Mugarte [9s Ad]
n00btimer: raises 22 to 42
PETROSOO42: calls 42
rekisser85: folds 
Caio Mugarte: folds 
nicolas_vm11: calls 42
Cheburah007: calls 42
J_d1nAlt: folds 
INISHTE: calls 32
frogz69: folds 
*** FLOP *** [Qs 3h 5c]
INISHTE: checks 
n00btimer: checks 
PETROSOO42: checks 
nicolas_vm11: checks 
Cheburah007: bets 280
INISHTE: folds 
n00btimer: folds 
PETROSOO42: folds 
nicolas_vm11: folds 
Uncalled bet (280) returned to Cheburah007
Cheburah007 collected 257 from pot
Cheburah007: doesn't show hand 
*** SUMMARY ***
Total pot 257 | Rake 0 
Board [Qs 3h 5c]
Seat 1: INISHTE (small blind) folded on the Flop
Seat 2: frogz69 (big blind) folded before Flop
Seat 3: n00btimer folded on the Flop
Seat 4: PETROSOO42 folded on the Flop
Seat 5: rekisser85 folded before Flop (didn't bet)
Seat 6: Caio Mugarte folded before Flop (didn't bet)
Seat 7: nicolas_vm11 folded on the Flop
Seat 8: Cheburah007 collected (257)
Seat 9: J_d1nAlt (button) folded before Flop (didn't bet)



PokerStars Hand #245446426905: Tournament #3632677041, $0.23+$0.02 USD Hold'em No Limit - Level I (10/20) - 2023/08/17 17:31:15 AT [2023/08/17 16:31:15 ET]
Table '3632677041 3' 9-max Seat #1 is the button
Seat 1: INISHTE (1406 in chips) 
Seat 2: frogz69 (1468 in chips) 
Seat 3: n00btimer (1449 in chips) 
Seat 4: PETROSOO42 (1204 in chips) 
Seat 5: rekisser85 (1426 in chips) 
Seat 6: Caio Mugarte (3045 in chips) 
Seat 7: nicolas_vm11 (1455 in chips) 
Seat 8: Cheburah007 (1685 in chips) 
Seat 9: J_d1nAlt (1904 in chips) 
INISHTE: posts the ante 3
frogz69: posts the ante 3
n00btimer: posts the ante 3
PETROSOO42: posts the ante 3
rekisser85: posts the ante 3
Caio Mugarte: posts the ante 3
nicolas_vm11: posts the ante 3
Cheburah007: posts the ante 3
J_d1nAlt: posts the ante 3
frogz69: posts small blind 10
n00btimer: posts big blind 20
*** HOLE CARDS ***
Dealt to Caio Mugarte [6c 5h]
PETROSOO42: folds 
rekisser85: folds 
Caio Mugarte: folds 
nicolas_vm11: folds 
Cheburah007: folds 
J_d1nAlt: calls 20
INISHTE: folds 
frogz69: folds 
n00btimer: checks 
*** FLOP *** [Kd Ac 9d]
n00btimer: checks 
J_d1nAlt: checks 
*** TURN *** [Kd Ac 9d] [7s]
n00btimer: checks 
J_d1nAlt: checks 
*** RIVER *** [Kd Ac 9d 7s] [Jh]
n00btimer: checks 
J_d1nAlt: checks 
*** SHOW DOWN ***
n00btimer: shows [9h Td] (a pair of Nines)
J_d1nAlt: mucks hand 
n00btimer collected 77 from pot
*** SUMMARY ***
Total pot 77 | Rake 0 
Board [Kd Ac 9d 7s Jh]
Seat 1: INISHTE (button) folded before Flop (didn't bet)
Seat 2: frogz69 (small blind) folded before Flop
Seat 3: n00btimer (big blind) showed [9h Td] and won (77) with a pair of Nines
Seat 4: PETROSOO42 folded before Flop (didn't bet)
Seat 5: rekisser85 folded before Flop (didn't bet)
Seat 6: Caio Mugarte folded before Flop (didn't bet)
Seat 7: nicolas_vm11 folded before Flop (didn't bet)
Seat 8: Cheburah007 folded before Flop (didn't bet)
Seat 9: J_d1nAlt mucked [3h Qh]



PokerStars Hand #245446445844: Tournament #3632677041, $0.23+$0.02 USD Hold'em No Limit - Level I (10/20) - 2023/08/17 17:32:09 AT [2023/08/17 16:32:09 ET]
Table '3632677041 3' 9-max Seat #2 is the button
Seat 1: INISHTE (1403 in chips) 
Seat 2: frogz69 (1455 in chips) 
Seat 3: n00btimer (1503 in chips) 
Seat 4: PETROSOO42 (1201 in chips) 
Seat 5: rekisser85 (1423 in chips) 
Seat 6: Caio Mugarte (3042 in chips) 
Seat 7: nicolas_vm11 (1452 in chips) 
Seat 8: Cheburah007 (1682 in chips) 
Seat 9: J_d1nAlt (1881 in chips) 
INISHTE: posts the ante 3
frogz69: posts the ante 3
n00btimer: posts the ante 3
PETROSOO42: posts the ante 3
rekisser85: posts the ante 3
Caio Mugarte: posts the ante 3
nicolas_vm11: posts the ante 3
Cheburah007: posts the ante 3
J_d1nAlt: posts the ante 3
n00btimer: posts small blind 10
PETROSOO42: posts big blind 20
*** HOLE CARDS ***
Dealt to Caio Mugarte [6h Qs]
rekisser85: folds 
Caio Mugarte: folds 
nicolas_vm11: folds 
Cheburah007: folds 
J_d1nAlt: folds 
INISHTE: folds 
frogz69: folds 
n00btimer: folds 
Uncalled bet (10) returned to PETROSOO42
PETROSOO42 collected 47 from pot
PETROSOO42: doesn't show hand 
*** SUMMARY ***
Total pot 47 | Rake 0 
Seat 1: INISHTE folded before Flop (didn't bet)
Seat 2: frogz69 (button) folded before Flop (didn't bet)
Seat 3: n00btimer (small blind) folded before Flop
Seat 4: PETROSOO42 (big blind) collected (47)
Seat 5: rekisser85 folded before Flop (didn't bet)
Seat 6: Caio Mugarte folded before Flop (didn't bet)
Seat 7: nicolas_vm11 folded before Flop (didn't bet)
Seat 8: Cheburah007 folded before Flop (didn't bet)
Seat 9: J_d1nAlt folded before Flop (didn't bet)



PokerStars Hand #245446451399: Tournament #3632677041, $0.23+$0.02 USD Hold'em No Limit - Level I (10/20) - 2023/08/17 17:32:25 AT [2023/08/17 16:32:25 ET]
Table '3632677041 3' 9-max Seat #3 is the button
Seat 1: INISHTE (1400 in chips) 
Seat 2: frogz69 (1452 in chips) 
Seat 3: n00btimer (1490 in chips) 
Seat 4: PETROSOO42 (1235 in chips) 
Seat 6: Caio Mugarte (3039 in chips) 
Seat 7: nicolas_vm11 (1449 in chips) 
Seat 8: Cheburah007 (1679 in chips) 
Seat 9: J_d1nAlt (1878 in chips) 
INISHTE: posts the ante 3
frogz69: posts the ante 3
n00btimer: posts the ante 3
PETROSOO42: posts the ante 3
Caio Mugarte: posts the ante 3
nicolas_vm11: posts the ante 3
Cheburah007: posts the ante 3
J_d1nAlt: posts the ante 3
PETROSOO42: posts small blind 10
Caio Mugarte: posts big blind 20
*** HOLE CARDS ***
Dealt to Caio Mugarte [2c 4d]
nicolas_vm11: raises 20 to 40
Cheburah007: calls 40
J_d1nAlt: calls 40
INISHTE: folds 
frogz69: folds 
n00btimer: calls 40
PETROSOO42: folds 
Caio Mugarte: folds 
*** FLOP *** [Kd Ts 5d]
nicolas_vm11: checks 
Cheburah007: bets 20
J_d1nAlt: folds 
n00btimer: calls 20
nicolas_vm11: calls 20
*** TURN *** [Kd Ts 5d] [Kh]
nicolas_vm11: checks 
Cheburah007: checks 
n00btimer: checks 
*** RIVER *** [Kd Ts 5d Kh] [Ah]
nicolas_vm11: checks 
Cheburah007: bets 40
n00btimer: calls 40
nicolas_vm11: calls 40
*** SHOW DOWN ***
Cheburah007: shows [4h Ad] (two pair, Aces and Kings)
n00btimer: shows [As Js] (two pair, Aces and Kings - Jack kicker)
nicolas_vm11: mucks hand 
n00btimer collected 394 from pot
*** SUMMARY ***
Total pot 394 | Rake 0 
Board [Kd Ts 5d Kh Ah]
Seat 1: INISHTE folded before Flop (didn't bet)
Seat 2: frogz69 folded before Flop (didn't bet)
Seat 3: n00btimer (button) showed [As Js] and won (394) with two pair, Aces and Kings
Seat 4: PETROSOO42 (small blind) folded before Flop
Seat 6: Caio Mugarte (big blind) folded before Flop
Seat 7: nicolas_vm11 mucked [3d 3h]
Seat 8: Cheburah007 showed [4h Ad] and lost with two pair, Aces and Kings
Seat 9: J_d1nAlt folded on the Flop



PokerStars Hand #245446477505: Tournament #3632677041, $0.23+$0.02 USD Hold'em No Limit - Level I (10/20) - 2023/08/17 17:33:40 AT [2023/08/17 16:33:40 ET]
Table '3632677041 3' 9-max Seat #4 is the button
Seat 1: INISHTE (1397 in chips) 
Seat 2: frogz69 (1449 in chips) 
Seat 3: n00btimer (1781 in chips) 
Seat 4: PETROSOO42 (1222 in chips) 
Seat 6: Caio Mugarte (3016 in chips) 
Seat 7: nicolas_vm11 (1346 in chips) 
Seat 8: Cheburah007 (1576 in chips) 
Seat 9: J_d1nAlt (1835 in chips) 
INISHTE: posts the ante 3
frogz69: posts the ante 3
n00btimer: posts the ante 3
PETROSOO42: posts the ante 3
Caio Mugarte: posts the ante 3
nicolas_vm11: posts the ante 3
Cheburah007: posts the ante 3
J_d1nAlt: posts the ante 3
Caio Mugarte: posts small blind 10
nicolas_vm11: posts big blind 20
*** HOLE CARDS ***
Dealt to Caio Mugarte [8s 9h]
Cheburah007: folds 
J_d1nAlt: raises 20 to 40
INISHTE: folds 
frogz69: folds 
n00btimer: folds 
PETROSOO42: calls 40
Caio Mugarte: folds 
nicolas_vm11: raises 40 to 80
J_d1nAlt: calls 40
PETROSOO42: calls 40
*** FLOP *** [5s 8c 3d]
nicolas_vm11: bets 80
J_d1nAlt: folds 
PETROSOO42: calls 80
*** TURN *** [5s 8c 3d] [5d]
nicolas_vm11: bets 100
PETROSOO42: calls 100
*** RIVER *** [5s 8c 3d 5d] [2c]
nicolas_vm11: bets 100
PETROSOO42: calls 100
*** SHOW DOWN ***
nicolas_vm11: shows [As Ad] (two pair, Aces and Fives)
PETROSOO42: mucks hand 
nicolas_vm11 collected 834 from pot
*** SUMMARY ***
Total pot 834 | Rake 0 
Board [5s 8c 3d 5d 2c]
Seat 1: INISHTE folded before Flop (didn't bet)
Seat 2: frogz69 folded before Flop (didn't bet)
Seat 3: n00btimer folded before Flop (didn't bet)
Seat 4: PETROSOO42 (button) mucked [Th 8h]
Seat 6: Caio Mugarte (small blind) folded before Flop
Seat 7: nicolas_vm11 (big blind) showed [As Ad] and won (834) with two pair, Aces and Fives
Seat 8: Cheburah007 folded before Flop (didn't bet)
Seat 9: J_d1nAlt folded on the Flop



PokerStars Hand #245446494576: Tournament #3632677041, $0.23+$0.02 USD Hold'em No Limit - Level II (15/30) - 2023/08/17 17:34:29 AT [2023/08/17 16:34:29 ET]
Table '3632677041 3' 9-max Seat #6 is the button
Seat 1: INISHTE (1394 in chips) 
Seat 2: frogz69 (1446 in chips) 
Seat 3: n00btimer (1778 in chips) 
Seat 4: PETROSOO42 (859 in chips) 
Seat 6: Caio Mugarte (3003 in chips) 
Seat 7: nicolas_vm11 (1817 in chips) 
Seat 8: Cheburah007 (1573 in chips) 
Seat 9: J_d1nAlt (1752 in chips) 
INISHTE: posts the ante 4
frogz69: posts the ante 4
n00btimer: posts the ante 4
PETROSOO42: posts the ante 4
Caio Mugarte: posts the ante 4
nicolas_vm11: posts the ante 4
Cheburah007: posts the ante 4
J_d1nAlt: posts the ante 4
nicolas_vm11: posts small blind 15
Cheburah007: posts big blind 30
*** HOLE CARDS ***
Dealt to Caio Mugarte [2d 3h]
J_d1nAlt: calls 30
INISHTE: folds 
frogz69: raises 36 to 66
n00btimer: calls 66
PETROSOO42: folds 
Caio Mugarte: folds 
nicolas_vm11: folds 
Cheburah007: calls 36
J_d1nAlt: calls 36
*** FLOP *** [9h 5s 3d]
Cheburah007: checks 
J_d1nAlt: checks 
frogz69: checks 
n00btimer: checks 
*** TURN *** [9h 5s 3d] [Th]
Cheburah007: checks 
J_d1nAlt: checks 
frogz69: bets 103
n00btimer: folds 
Cheburah007: folds 
J_d1nAlt: folds 
Uncalled bet (103) returned to frogz69
frogz69 collected 311 from pot
frogz69: doesn't show hand 
*** SUMMARY ***
Total pot 311 | Rake 0 
Board [9h 5s 3d Th]
Seat 1: INISHTE folded before Flop (didn't bet)
Seat 2: frogz69 collected (311)
Seat 3: n00btimer folded on the Turn
Seat 4: PETROSOO42 folded before Flop (didn't bet)
Seat 6: Caio Mugarte (button) folded before Flop (didn't bet)
Seat 7: nicolas_vm11 (small blind) folded before Flop
Seat 8: Cheburah007 (big blind) folded on the Turn
Seat 9: J_d1nAlt folded on the Turn



PokerStars Hand #245446533497: Tournament #3632677041, $0.23+$0.02 USD Hold'em No Limit - Level II (15/30) - 2023/08/17 17:36:23 AT [2023/08/17 16:36:23 ET]
Table '3632677041 3' 9-max Seat #7 is the button
Seat 1: INISHTE (1390 in chips) 
Seat 2: frogz69 (1687 in chips) 
Seat 3: n00btimer (1708 in chips) 
Seat 4: PETROSOO42 (855 in chips) 
Seat 6: Caio Mugarte (2999 in chips) 
Seat 7: nicolas_vm11 (1798 in chips) 
Seat 8: Cheburah007 (1503 in chips) 
Seat 9: J_d1nAlt (1682 in chips) 
INISHTE: posts the ante 4
frogz69: posts the ante 4
n00btimer: posts the ante 4
PETROSOO42: posts the ante 4
Caio Mugarte: posts the ante 4
nicolas_vm11: posts the ante 4
Cheburah007: posts the ante 4
J_d1nAlt: posts the ante 4
Cheburah007: posts small blind 15
J_d1nAlt: posts big blind 30
*** HOLE CARDS ***
Dealt to Caio Mugarte [Qd 8d]
INISHTE: raises 33 to 63
frogz69: folds 
n00btimer: calls 63
PETROSOO42: folds 
Caio Mugarte: folds 
nicolas_vm11: folds 
Cheburah007: folds 
J_d1nAlt: folds 
*** FLOP *** [Kd 3c 6s]
INISHTE: bets 63
n00btimer: folds 
Uncalled bet (63) returned to INISHTE
INISHTE collected 203 from pot
INISHTE: doesn't show hand 
*** SUMMARY ***
Total pot 203 | Rake 0 
Board [Kd 3c 6s]
Seat 1: INISHTE collected (203)
Seat 2: frogz69 folded before Flop (didn't bet)
Seat 3: n00btimer folded on the Flop
Seat 4: PETROSOO42 folded before Flop (didn't bet)
Seat 6: Caio Mugarte folded before Flop (didn't bet)
Seat 7: nicolas_vm11 (button) folded before Flop (didn't bet)
Seat 8: Cheburah007 (small blind) folded before Flop
Seat 9: J_d1nAlt (big blind) folded before Flop



PokerStars Hand #245446542630: Tournament #3632677041, $0.23+$0.02 USD Hold'em No Limit - Level II (15/30) - 2023/08/17 17:36:49 AT [2023/08/17 16:36:49 ET]
Table '3632677041 3' 9-max Seat #8 is the button
Seat 1: INISHTE (1526 in chips) 
Seat 2: frogz69 (1683 in chips) 
Seat 3: n00btimer (1641 in chips) 
Seat 4: PETROSOO42 (851 in chips) 
Seat 6: Caio Mugarte (2995 in chips) 
Seat 7: nicolas_vm11 (1794 in chips) 
Seat 8: Cheburah007 (1484 in chips) 
Seat 9: J_d1nAlt (1648 in chips) 
INISHTE: posts the ante 4
frogz69: posts the ante 4
n00btimer: posts the ante 4
PETROSOO42: posts the ante 4
Caio Mugarte: posts the ante 4
nicolas_vm11: posts the ante 4
Cheburah007: posts the ante 4
J_d1nAlt: posts the ante 4
J_d1nAlt: posts small blind 15
INISHTE: posts big blind 30
*** HOLE CARDS ***
Dealt to Caio Mugarte [Ts 8c]
frogz69: folds 
n00btimer: folds 
PETROSOO42: calls 30
Caio Mugarte: folds 
nicolas_vm11: calls 30
Cheburah007: calls 30
J_d1nAlt: calls 15
INISHTE: checks 
*** FLOP *** [Th 9c 3c]
J_d1nAlt: bets 30
INISHTE: calls 30
PETROSOO42: calls 30
nicolas_vm11: calls 30
Cheburah007: raises 60 to 90
J_d1nAlt: calls 60
INISHTE: calls 60
PETROSOO42: calls 60
nicolas_vm11: folds 
*** TURN *** [Th 9c 3c] [8d]
J_d1nAlt: checks 
INISHTE: checks 
PETROSOO42: checks 
Cheburah007: bets 120
J_d1nAlt: folds 
INISHTE: calls 120
PETROSOO42: folds 
*** RIVER *** [Th 9c 3c 8d] [Ad]
INISHTE: checks 
Cheburah007: checks 
*** SHOW DOWN ***
INISHTE: shows [6d 8s] (a pair of Eights)
Cheburah007: shows [Tc 9d] (two pair, Tens and Nines)
Cheburah007 collected 812 from pot
*** SUMMARY ***
Total pot 812 | Rake 0 
Board [Th 9c 3c 8d Ad]
Seat 1: INISHTE (big blind) showed [6d 8s] and lost with a pair of Eights
Seat 2: frogz69 folded before Flop (didn't bet)
Seat 3: n00btimer folded before Flop (didn't bet)
Seat 4: PETROSOO42 folded on the Turn
Seat 6: Caio Mugarte folded before Flop (didn't bet)
Seat 7: nicolas_vm11 folded on the Flop
Seat 8: Cheburah007 (button) showed [Tc 9d] and won (812) with two pair, Tens and Nines
Seat 9: J_d1nAlt (small blind) folded on the Turn



PokerStars Hand #245446572253: Tournament #3632677041, $0.23+$0.02 USD Hold'em No Limit - Level II (15/30) - 2023/08/17 17:38:15 AT [2023/08/17 16:38:15 ET]
Table '3632677041 3' 9-max Seat #9 is the button
Seat 1: INISHTE (1282 in chips) 
Seat 2: frogz69 (1679 in chips) 
Seat 3: n00btimer (1637 in chips) 
Seat 4: PETROSOO42 (727 in chips) 
Seat 6: Caio Mugarte (2991 in chips) 
Seat 7: nicolas_vm11 (1730 in chips) 
Seat 8: Cheburah007 (2052 in chips) 
Seat 9: J_d1nAlt (1524 in chips) 
INISHTE: posts the ante 4
frogz69: posts the ante 4
n00btimer: posts the ante 4
PETROSOO42: posts the ante 4
Caio Mugarte: posts the ante 4
nicolas_vm11: posts the ante 4
Cheburah007: posts the ante 4
J_d1nAlt: posts the ante 4
INISHTE: posts small blind 15
frogz69: posts big blind 30
*** HOLE CARDS ***
Dealt to Caio Mugarte [6d 8h]
n00btimer: folds 
PETROSOO42: folds 
Caio Mugarte: folds 
nicolas_vm11: folds 
Cheburah007: folds 
J_d1nAlt: folds 
INISHTE: folds 
Uncalled bet (15) returned to frogz69
frogz69 collected 62 from pot
frogz69: doesn't show hand 
*** SUMMARY ***
Total pot 62 | Rake 0 
Seat 1: INISHTE (small blind) folded before Flop
Seat 2: frogz69 (big blind) collected (62)
Seat 3: n00btimer folded before Flop (didn't bet)
Seat 4: PETROSOO42 folded before Flop (didn't bet)
Seat 6: Caio Mugarte folded before Flop (didn't bet)
Seat 7: nicolas_vm11 folded before Flop (didn't bet)
Seat 8: Cheburah007 folded before Flop (didn't bet)
Seat 9: J_d1nAlt (button) folded before Flop (didn't bet)



PokerStars Hand #245446580020: Tournament #3632677041, $0.23+$0.02 USD Hold'em No Limit - Level II (15/30) - 2023/08/17 17:38:38 AT [2023/08/17 16:38:38 ET]
Table '3632677041 3' 9-max Seat #1 is the button
Seat 1: INISHTE (1263 in chips) 
Seat 2: frogz69 (1722 in chips) 
Seat 3: n00btimer (1633 in chips) 
Seat 4: PETROSOO42 (723 in chips) 
Seat 6: Caio Mugarte (2987 in chips) 
Seat 7: nicolas_vm11 (1726 in chips) 
Seat 8: Cheburah007 (2048 in chips) 
Seat 9: J_d1nAlt (1520 in chips) 
INISHTE: posts the ante 4
frogz69: posts the ante 4
n00btimer: posts the ante 4
PETROSOO42: posts the ante 4
Caio Mugarte: posts the ante 4
nicolas_vm11: posts the ante 4
Cheburah007: posts the ante 4
J_d1nAlt: posts the ante 4
frogz69: posts small blind 15
n00btimer: posts big blind 30
*** HOLE CARDS ***
Dealt to Caio Mugarte [Kd 5d]
PETROSOO42: raises 30 to 60
Caio Mugarte: folds 
nicolas_vm11: folds 
Cheburah007: calls 60
J_d1nAlt: calls 60
INISHTE: folds 
frogz69: folds 
n00btimer: calls 30
*** FLOP *** [Kh 9h 5c]
n00btimer: checks 
PETROSOO42: checks 
Cheburah007: checks 
J_d1nAlt: checks 
*** TURN *** [Kh 9h 5c] [As]
n00btimer: checks 
PETROSOO42: checks 
Cheburah007: bets 60
J_d1nAlt: calls 60
n00btimer: folds 
PETROSOO42: folds 
*** RIVER *** [Kh 9h 5c As] [Td]
Cheburah007: checks 
J_d1nAlt: checks 
*** SHOW DOWN ***
Cheburah007: shows [8h Ac] (a pair of Aces)
J_d1nAlt: mucks hand 
Cheburah007 collected 407 from pot
*** SUMMARY ***
Total pot 407 | Rake 0 
Board [Kh 9h 5c As Td]
Seat 1: INISHTE (button) folded before Flop (didn't bet)
Seat 2: frogz69 (small blind) folded before Flop
Seat 3: n00btimer (big blind) folded on the Turn
Seat 4: PETROSOO42 folded on the Turn
Seat 6: Caio Mugarte folded before Flop (didn't bet)
Seat 7: nicolas_vm11 folded before Flop (didn't bet)
Seat 8: Cheburah007 showed [8h Ac] and won (407) with a pair of Aces
Seat 9: J_d1nAlt mucked [7s 7d]



PokerStars Hand #245446607564: Tournament #3632677041, $0.23+$0.02 USD Hold'em No Limit - Level II (15/30) - 2023/08/17 17:39:58 AT [2023/08/17 16:39:58 ET]
Table '3632677041 3' 9-max Seat #2 is the button
Seat 1: INISHTE (1259 in chips) 
Seat 2: frogz69 (1703 in chips) 
Seat 3: n00btimer (1569 in chips) 
Seat 4: PETROSOO42 (659 in chips) 
Seat 6: Caio Mugarte (2983 in chips) 
Seat 7: nicolas_vm11 (1722 in chips) 
Seat 8: Cheburah007 (2331 in chips) 
Seat 9: J_d1nAlt (1396 in chips) 
INISHTE: posts the ante 4
frogz69: posts the ante 4
n00btimer: posts the ante 4
PETROSOO42: posts the ante 4
Caio Mugarte: posts the ante 4
nicolas_vm11: posts the ante 4
Cheburah007: posts the ante 4
J_d1nAlt: posts the ante 4
n00btimer: posts small blind 15
PETROSOO42: posts big blind 30
*** HOLE CARDS ***
Dealt to Caio Mugarte [Qc Ad]
Caio Mugarte: raises 30 to 60
nicolas_vm11: raises 30 to 90
Cheburah007: folds 
J_d1nAlt: folds 
INISHTE: folds 
frogz69: calls 90
n00btimer: calls 75
PETROSOO42: folds 
Caio Mugarte: calls 30
*** FLOP *** [Ah 8h Kd]
n00btimer: checks 
Caio Mugarte: checks 
nicolas_vm11: bets 120
frogz69: raises 240 to 360
n00btimer: folds 
Caio Mugarte: calls 360
nicolas_vm11: folds 
*** TURN *** [Ah 8h Kd] [2s]
Caio Mugarte: checks 
frogz69: bets 390
Caio Mugarte: calls 390
*** RIVER *** [Ah 8h Kd 2s] [5d]
Caio Mugarte: checks 
frogz69: bets 859 and is all-in
Caio Mugarte: calls 859
*** SHOW DOWN ***
frogz69: shows [8s 8c] (three of a kind, Eights)
Caio Mugarte: shows [Qc Ad] (a pair of Aces)
frogz69 collected 3760 from pot
*** SUMMARY ***
Total pot 3760 | Rake 0 
Board [Ah 8h Kd 2s 5d]
Seat 1: INISHTE folded before Flop (didn't bet)
Seat 2: frogz69 (button) showed [8s 8c] and won (3760) with three of a kind, Eights
Seat 3: n00btimer (small blind) folded on the Flop
Seat 4: PETROSOO42 (big blind) folded before Flop
Seat 6: Caio Mugarte showed [Qc Ad] and lost with a pair of Aces
Seat 7: nicolas_vm11 folded on the Flop
Seat 8: Cheburah007 folded before Flop (didn't bet)
Seat 9: J_d1nAlt folded before Flop (didn't bet)



PokerStars Hand #245446653604: Tournament #3632677041, $0.23+$0.02 USD Hold'em No Limit - Level II (15/30) - 2023/08/17 17:42:12 AT [2023/08/17 16:42:12 ET]
Table '3632677041 3' 9-max Seat #3 is the button
Seat 1: INISHTE (1255 in chips) 
Seat 2: frogz69 (3760 in chips) 
Seat 3: n00btimer (1475 in chips) 
Seat 4: PETROSOO42 (625 in chips) 
Seat 6: Caio Mugarte (1280 in chips) 
Seat 7: nicolas_vm11 (1508 in chips) 
Seat 8: Cheburah007 (2327 in chips) 
Seat 9: J_d1nAlt (1392 in chips) 
INISHTE: posts the ante 4
frogz69: posts the ante 4
n00btimer: posts the ante 4
PETROSOO42: posts the ante 4
Caio Mugarte: posts the ante 4
nicolas_vm11: posts the ante 4
Cheburah007: posts the ante 4
J_d1nAlt: posts the ante 4
PETROSOO42: posts small blind 15
Caio Mugarte: posts big blind 30
*** HOLE CARDS ***
Dealt to Caio Mugarte [6s 7h]
nicolas_vm11: calls 30
Cheburah007: calls 30
J_d1nAlt: folds 
INISHTE: folds 
frogz69: folds 
n00btimer: folds 
PETROSOO42: calls 15
Caio Mugarte: checks 
*** FLOP *** [Kh 6h Ts]
PETROSOO42: bets 30
Caio Mugarte: folds 
nicolas_vm11: calls 30
Cheburah007: folds 
*** TURN *** [Kh 6h Ts] [As]
PETROSOO42: checks 
nicolas_vm11: bets 90
PETROSOO42: calls 90
*** RIVER *** [Kh 6h Ts As] [3s]
PETROSOO42: bets 471 and is all-in
nicolas_vm11: calls 471
*** SHOW DOWN ***
PETROSOO42: shows [Ah 3c] (two pair, Aces and Threes)
nicolas_vm11: shows [7s Ad] (a pair of Aces)
PETROSOO42 collected 1334 from pot
*** SUMMARY ***
Total pot 1334 | Rake 0 
Board [Kh 6h Ts As 3s]
Seat 1: INISHTE folded before Flop (didn't bet)
Seat 2: frogz69 folded before Flop (didn't bet)
Seat 3: n00btimer (button) folded before Flop (didn't bet)
Seat 4: PETROSOO42 (small blind) showed [Ah 3c] and won (1334) with two pair, Aces and Threes
Seat 6: Caio Mugarte (big blind) folded on the Flop
Seat 7: nicolas_vm11 showed [7s Ad] and lost with a pair of Aces
Seat 8: Cheburah007 folded on the Flop
Seat 9: J_d1nAlt folded before Flop (didn't bet)



PokerStars Hand #245446671951: Tournament #3632677041, $0.23+$0.02 USD Hold'em No Limit - Level II (15/30) - 2023/08/17 17:43:05 AT [2023/08/17 16:43:05 ET]
Table '3632677041 3' 9-max Seat #4 is the button
Seat 1: INISHTE (1251 in chips) 
Seat 2: frogz69 (3756 in chips) 
Seat 3: n00btimer (1471 in chips) 
Seat 4: PETROSOO42 (1334 in chips) 
Seat 6: Caio Mugarte (1246 in chips) 
Seat 7: nicolas_vm11 (883 in chips) 
Seat 8: Cheburah007 (2293 in chips) 
Seat 9: J_d1nAlt (1388 in chips) 
INISHTE: posts the ante 4
frogz69: posts the ante 4
n00btimer: posts the ante 4
PETROSOO42: posts the ante 4
Caio Mugarte: posts the ante 4
nicolas_vm11: posts the ante 4
Cheburah007: posts the ante 4
J_d1nAlt: posts the ante 4
Caio Mugarte: posts small blind 15
nicolas_vm11: posts big blind 30
*** HOLE CARDS ***
Dealt to Caio Mugarte [4c 7h]
Cheburah007: calls 30
J_d1nAlt: raises 30 to 60
INISHTE: folds 
frogz69: folds 
n00btimer: folds 
PETROSOO42: calls 60
Caio Mugarte: folds 
nicolas_vm11: calls 30
Cheburah007: calls 30
*** FLOP *** [9c 8h Ts]
nicolas_vm11: checks 
Cheburah007: checks 
J_d1nAlt: bets 60
PETROSOO42: folds 
nicolas_vm11: calls 60
Cheburah007: calls 60
*** TURN *** [9c 8h Ts] [Ks]
nicolas_vm11: bets 210
Cheburah007: calls 210
J_d1nAlt: folds 
*** RIVER *** [9c 8h Ts Ks] [8c]
nicolas_vm11: bets 549 and is all-in
Cheburah007: folds 
Uncalled bet (549) returned to nicolas_vm11
nicolas_vm11 collected 887 from pot
nicolas_vm11: doesn't show hand 
*** SUMMARY ***
Total pot 887 | Rake 0 
Board [9c 8h Ts Ks 8c]
Seat 1: INISHTE folded before Flop (didn't bet)
Seat 2: frogz69 folded before Flop (didn't bet)
Seat 3: n00btimer folded before Flop (didn't bet)
Seat 4: PETROSOO42 (button) folded on the Flop
Seat 6: Caio Mugarte (small blind) folded before Flop
Seat 7: nicolas_vm11 (big blind) collected (887)
Seat 8: Cheburah007 folded on the River
Seat 9: J_d1nAlt folded on the Turn



PokerStars Hand #245446700628: Tournament #3632677041, $0.23+$0.02 USD Hold'em No Limit - Level III (25/50) - 2023/08/17 17:44:30 AT [2023/08/17 16:44:30 ET]
Table '3632677041 3' 9-max Seat #6 is the button
Seat 1: INISHTE (1247 in chips) 
Seat 2: frogz69 (3752 in chips) 
Seat 3: n00btimer (1467 in chips) 
Seat 4: PETROSOO42 (1270 in chips) 
Seat 5: Obito-U (1323 in chips) 
Seat 6: Caio Mugarte (1227 in chips) 
Seat 7: nicolas_vm11 (1436 in chips) 
Seat 8: Cheburah007 (1959 in chips) 
Seat 9: J_d1nAlt (1264 in chips) 
INISHTE: posts the ante 6
frogz69: posts the ante 6
n00btimer: posts the ante 6
PETROSOO42: posts the ante 6
Obito-U: posts the ante 6
Caio Mugarte: posts the ante 6
nicolas_vm11: posts the ante 6
Cheburah007: posts the ante 6
J_d1nAlt: posts the ante 6
nicolas_vm11: posts small blind 25
Cheburah007: posts big blind 50
*** HOLE CARDS ***
Dealt to Caio Mugarte [2s Qs]
J_d1nAlt: folds 
INISHTE: folds 
frogz69: folds 
n00btimer: folds 
PETROSOO42: calls 50
Obito-U is disconnected 
Obito-U is connected 
Obito-U is connected 
Obito-U: calls 50
Caio Mugarte: folds 
nicolas_vm11: calls 25
Cheburah007: checks 
*** FLOP *** [Jh 7d 4h]
nicolas_vm11: checks 
Cheburah007: bets 50
PETROSOO42: folds 
Obito-U: calls 50
nicolas_vm11: calls 50
*** TURN *** [Jh 7d 4h] [5d]
Obito-U is disconnected 
nicolas_vm11: bets 150
Cheburah007: raises 250 to 400
Obito-U: folds 
nicolas_vm11: raises 250 to 650
Cheburah007: calls 250
*** RIVER *** [Jh 7d 4h 5d] [5c]
nicolas_vm11: bets 400
Cheburah007: raises 400 to 800
nicolas_vm11: calls 280 and is all-in
Uncalled bet (120) returned to Cheburah007
*** SHOW DOWN ***
Cheburah007: shows [5s 7c] (a full house, Fives full of Sevens)
nicolas_vm11: shows [6c 3d] (a straight, Three to Seven)
Cheburah007 collected 3064 from pot
nicolas_vm11 finished the tournament in 35th place
*** SUMMARY ***
Total pot 3064 | Rake 0 
Board [Jh 7d 4h 5d 5c]
Seat 1: INISHTE folded before Flop (didn't bet)
Seat 2: frogz69 folded before Flop (didn't bet)
Seat 3: n00btimer folded before Flop (didn't bet)
Seat 4: PETROSOO42 folded on the Flop
Seat 5: Obito-U folded on the Turn
Seat 6: Caio Mugarte (button) folded before Flop (didn't bet)
Seat 7: nicolas_vm11 (small blind) showed [6c 3d] and lost with a straight, Three to Seven
Seat 8: Cheburah007 (big blind) showed [5s 7c] and won (3064) with a full house, Fives full of Sevens
Seat 9: J_d1nAlt folded before Flop (didn't bet)



PokerStars Hand #245446729628: Tournament #3632677041, $0.23+$0.02 USD Hold'em No Limit - Level III (25/50) - 2023/08/17 17:45:55 AT [2023/08/17 16:45:55 ET]
Table '3632677041 3' 9-max Seat #8 is the button
Seat 1: INISHTE (1241 in chips) 
Seat 2: frogz69 (3746 in chips) 
Seat 3: n00btimer (1461 in chips) 
Seat 4: PETROSOO42 (1214 in chips) 
Seat 5: Obito-U (1217 in chips) 
Seat 6: Caio Mugarte (1221 in chips) 
Seat 8: Cheburah007 (3587 in chips) 
Seat 9: J_d1nAlt (1258 in chips) 
INISHTE: posts the ante 6
frogz69: posts the ante 6
n00btimer: posts the ante 6
PETROSOO42: posts the ante 6
Obito-U: posts the ante 6
Caio Mugarte: posts the ante 6
Cheburah007: posts the ante 6
J_d1nAlt: posts the ante 6
J_d1nAlt: posts small blind 25
INISHTE: posts big blind 50
*** HOLE CARDS ***
Dealt to Caio Mugarte [Kd 4c]
frogz69: raises 50 to 100
n00btimer: folds 
PETROSOO42: calls 100
Obito-U: folds 
Caio Mugarte: folds 
Cheburah007: folds 
J_d1nAlt: calls 75
INISHTE: calls 50
*** FLOP *** [5c 8d As]
J_d1nAlt: checks 
INISHTE: checks 
frogz69: bets 112
PETROSOO42: calls 112
J_d1nAlt: folds 
INISHTE: calls 112
*** TURN *** [5c 8d As] [2s]
INISHTE: checks 
frogz69: bets 392
PETROSOO42: calls 392
INISHTE: folds 
*** RIVER *** [5c 8d As 2s] [4d]
frogz69: checks 
PETROSOO42: bets 604 and is all-in
frogz69: folds 
Uncalled bet (604) returned to PETROSOO42
PETROSOO42 collected 1568 from pot
PETROSOO42: doesn't show hand 
*** SUMMARY ***
Total pot 1568 | Rake 0 
Board [5c 8d As 2s 4d]
Seat 1: INISHTE (big blind) folded on the Turn
Seat 2: frogz69 folded on the River
Seat 3: n00btimer folded before Flop (didn't bet)
Seat 4: PETROSOO42 collected (1568)
Seat 5: Obito-U folded before Flop (didn't bet)
Seat 6: Caio Mugarte folded before Flop (didn't bet)
Seat 8: Cheburah007 (button) folded before Flop (didn't bet)
Seat 9: J_d1nAlt (small blind) folded on the Flop



PokerStars Hand #245446764202: Tournament #3632677041, $0.23+$0.02 USD Hold'em No Limit - Level III (25/50) - 2023/08/17 17:47:35 AT [2023/08/17 16:47:35 ET]
Table '3632677041 3' 9-max Seat #9 is the button
Seat 1: INISHTE (1023 in chips) 
Seat 2: frogz69 (3136 in chips) 
Seat 3: n00btimer (1455 in chips) 
Seat 4: PETROSOO42 (2172 in chips) 
Seat 5: Obito-U (1211 in chips) 
Seat 6: Caio Mugarte (1215 in chips) 
Seat 8: Cheburah007 (3581 in chips) 
Seat 9: J_d1nAlt (1152 in chips) 
INISHTE: posts the ante 6
frogz69: posts the ante 6
n00btimer: posts the ante 6
PETROSOO42: posts the ante 6
Obito-U: posts the ante 6
Caio Mugarte: posts the ante 6
Cheburah007: posts the ante 6
J_d1nAlt: posts the ante 6
INISHTE: posts small blind 25
frogz69: posts big blind 50
*** HOLE CARDS ***
Dealt to Caio Mugarte [Ad 2h]
n00btimer: folds 
PETROSOO42: calls 50
Obito-U: folds 
Caio Mugarte: folds 
Cheburah007: calls 50
J_d1nAlt: raises 50 to 100
INISHTE: folds 
frogz69: calls 50
PETROSOO42: calls 50
Cheburah007: calls 50
*** FLOP *** [Ah 7c 3h]
frogz69: checks 
PETROSOO42: checks 
Cheburah007: checks 
J_d1nAlt: checks 
*** TURN *** [Ah 7c 3h] [Td]
frogz69: checks 
PETROSOO42: checks 
Cheburah007: checks 
J_d1nAlt: checks 
*** RIVER *** [Ah 7c 3h Td] [5h]
frogz69: bets 200
PETROSOO42: calls 200
Cheburah007: folds 
J_d1nAlt: folds 
*** SHOW DOWN ***
frogz69: shows [7h 9h] (a flush, Ace high)
PETROSOO42: mucks hand 
frogz69 collected 873 from pot
*** SUMMARY ***
Total pot 873 | Rake 0 
Board [Ah 7c 3h Td 5h]
Seat 1: INISHTE (small blind) folded before Flop
Seat 2: frogz69 (big blind) showed [7h 9h] and won (873) with a flush, Ace high
Seat 3: n00btimer folded before Flop (didn't bet)
Seat 4: PETROSOO42 mucked [Ts Jh]
Seat 5: Obito-U folded before Flop (didn't bet)
Seat 6: Caio Mugarte folded before Flop (didn't bet)
Seat 8: Cheburah007 folded on the River
Seat 9: J_d1nAlt (button) folded on the River



PokerStars Hand #245446786689: Tournament #3632677041, $0.23+$0.02 USD Hold'em No Limit - Level III (25/50) - 2023/08/17 17:48:41 AT [2023/08/17 16:48:41 ET]
Table '3632677041 3' 9-max Seat #1 is the button
Seat 1: INISHTE (992 in chips) 
Seat 2: frogz69 (3703 in chips) 
Seat 3: n00btimer (1449 in chips) 
Seat 4: PETROSOO42 (1866 in chips) 
Seat 5: Obito-U (1205 in chips) 
Seat 6: Caio Mugarte (1209 in chips) 
Seat 8: Cheburah007 (3475 in chips) 
Seat 9: J_d1nAlt (1046 in chips) 
INISHTE: posts the ante 6
frogz69: posts the ante 6
n00btimer: posts the ante 6
PETROSOO42: posts the ante 6
Obito-U: posts the ante 6
Caio Mugarte: posts the ante 6
Cheburah007: posts the ante 6
J_d1nAlt: posts the ante 6
frogz69: posts small blind 25
n00btimer: posts big blind 50
*** HOLE CARDS ***
Dealt to Caio Mugarte [Ts 6c]
PETROSOO42: folds 
Obito-U: folds 
Caio Mugarte: folds 
Cheburah007: raises 50 to 100
J_d1nAlt: calls 100
INISHTE: folds 
frogz69: folds 
n00btimer: calls 50
*** FLOP *** [Ks Js 7h]
n00btimer: checks 
Cheburah007: checks 
J_d1nAlt: checks 
*** TURN *** [Ks Js 7h] [9h]
n00btimer: checks 
Cheburah007: checks 
J_d1nAlt: checks 
*** RIVER *** [Ks Js 7h 9h] [Jd]
n00btimer: checks 
Cheburah007: bets 150
J_d1nAlt: calls 150
n00btimer: calls 150
*** SHOW DOWN ***
Cheburah007: shows [Ad 5h] (a pair of Jacks)
J_d1nAlt: shows [9d 8c] (two pair, Jacks and Nines)
n00btimer: shows [Qh 9c] (two pair, Jacks and Nines)
n00btimer collected 412 from pot
J_d1nAlt collected 411 from pot
*** SUMMARY ***
Total pot 823 | Rake 0 
Board [Ks Js 7h 9h Jd]
Seat 1: INISHTE (button) folded before Flop (didn't bet)
Seat 2: frogz69 (small blind) folded before Flop
Seat 3: n00btimer (big blind) showed [Qh 9c] and won (412) with two pair, Jacks and Nines
Seat 4: PETROSOO42 folded before Flop (didn't bet)
Seat 5: Obito-U folded before Flop (didn't bet)
Seat 6: Caio Mugarte folded before Flop (didn't bet)
Seat 8: Cheburah007 showed [Ad 5h] and lost with a pair of Jacks
Seat 9: J_d1nAlt showed [9d 8c] and won (411) with two pair, Jacks and Nines



PokerStars Hand #245446805942: Tournament #3632677041, $0.23+$0.02 USD Hold'em No Limit - Level III (25/50) - 2023/08/17 17:49:37 AT [2023/08/17 16:49:37 ET]
Table '3632677041 3' 9-max Seat #2 is the button
Seat 1: INISHTE (986 in chips) 
Seat 2: frogz69 (3672 in chips) 
Seat 3: n00btimer (1605 in chips) 
Seat 4: PETROSOO42 (1860 in chips) 
Seat 5: Obito-U (1199 in chips) 
Seat 6: Caio Mugarte (1203 in chips) 
Seat 8: Cheburah007 (3219 in chips) 
Seat 9: J_d1nAlt (1201 in chips) 
INISHTE: posts the ante 6
frogz69: posts the ante 6
n00btimer: posts the ante 6
PETROSOO42: posts the ante 6
Obito-U: posts the ante 6
Caio Mugarte: posts the ante 6
Cheburah007: posts the ante 6
J_d1nAlt: posts the ante 6
n00btimer: posts small blind 25
PETROSOO42: posts big blind 50
*** HOLE CARDS ***
Dealt to Caio Mugarte [4s 6h]
Obito-U: raises 50 to 100
Caio Mugarte: folds 
Cheburah007: folds 
J_d1nAlt: folds 
INISHTE: calls 100
frogz69: raises 275 to 375
n00btimer: folds 
PETROSOO42: folds 
Obito-U: calls 275
INISHTE: folds 
*** FLOP *** [Js 8h 2s]
Obito-U: checks 
frogz69: bets 275
Obito-U: raises 543 to 818 and is all-in
frogz69: calls 543
*** TURN *** [Js 8h 2s] [Jh]
*** RIVER *** [Js 8h 2s Jh] [2c]
*** SHOW DOWN ***
Obito-U: shows [7s Ks] (two pair, Jacks and Deuces)
frogz69: shows [Ah Ac] (two pair, Aces and Jacks)
frogz69 collected 2609 from pot
Obito-U finished the tournament in 31st place
*** SUMMARY ***
Total pot 2609 | Rake 0 
Board [Js 8h 2s Jh 2c]
Seat 1: INISHTE folded before Flop
Seat 2: frogz69 (button) showed [Ah Ac] and won (2609) with two pair, Aces and Jacks
Seat 3: n00btimer (small blind) folded before Flop
Seat 4: PETROSOO42 (big blind) folded before Flop
Seat 5: Obito-U showed [7s Ks] and lost with two pair, Jacks and Deuces
Seat 6: Caio Mugarte folded before Flop (didn't bet)
Seat 8: Cheburah007 folded before Flop (didn't bet)
Seat 9: J_d1nAlt folded before Flop (didn't bet)



PokerStars Hand #245446829467: Tournament #3632677041, $0.23+$0.02 USD Hold'em No Limit - Level III (25/50) - 2023/08/17 17:50:47 AT [2023/08/17 16:50:47 ET]
Table '3632677041 3' 9-max Seat #3 is the button
Seat 1: INISHTE (880 in chips) 
Seat 2: frogz69 (5082 in chips) 
Seat 3: n00btimer (1574 in chips) 
Seat 4: PETROSOO42 (1804 in chips) 
Seat 6: Caio Mugarte (1197 in chips) 
Seat 8: Cheburah007 (3213 in chips) 
Seat 9: J_d1nAlt (1195 in chips) 
INISHTE: posts the ante 6
frogz69: posts the ante 6
n00btimer: posts the ante 6
PETROSOO42: posts the ante 6
Caio Mugarte: posts the ante 6
Cheburah007: posts the ante 6
J_d1nAlt: posts the ante 6
PETROSOO42: posts small blind 25
Caio Mugarte: posts big blind 50
*** HOLE CARDS ***
Dealt to Caio Mugarte [5h 2h]
Cheburah007: folds 
J_d1nAlt: calls 50
INISHTE: folds 
frogz69: folds 
n00btimer: folds 
PETROSOO42: calls 25
Caio Mugarte: checks 
*** FLOP *** [2c Jh Qs]
PETROSOO42: checks 
Caio Mugarte: checks 
J_d1nAlt: checks 
*** TURN *** [2c Jh Qs] [3d]
PETROSOO42: checks 
Caio Mugarte: checks 
J_d1nAlt: checks 
*** RIVER *** [2c Jh Qs 3d] [Qd]
PETROSOO42: checks 
Caio Mugarte: checks 
J_d1nAlt: checks 
*** SHOW DOWN ***
PETROSOO42: shows [6c 3h] (two pair, Queens and Threes)
Caio Mugarte: mucks hand 
J_d1nAlt: mucks hand 
PETROSOO42 collected 192 from pot
*** SUMMARY ***
Total pot 192 | Rake 0 
Board [2c Jh Qs 3d Qd]
Seat 1: INISHTE folded before Flop (didn't bet)
Seat 2: frogz69 folded before Flop (didn't bet)
Seat 3: n00btimer (button) folded before Flop (didn't bet)
Seat 4: PETROSOO42 (small blind) showed [6c 3h] and won (192) with two pair, Queens and Threes
Seat 6: Caio Mugarte (big blind) mucked [5h 2h]
Seat 8: Cheburah007 folded before Flop (didn't bet)
Seat 9: J_d1nAlt mucked [Td 6d]



PokerStars Hand #245446844585: Tournament #3632677041, $0.23+$0.02 USD Hold'em No Limit - Level III (25/50) - 2023/08/17 17:51:31 AT [2023/08/17 16:51:31 ET]
Table '3632677041 3' 9-max Seat #4 is the button
Seat 1: INISHTE (874 in chips) 
Seat 2: frogz69 (5076 in chips) 
Seat 3: n00btimer (1568 in chips) 
Seat 4: PETROSOO42 (1940 in chips) 
Seat 6: Caio Mugarte (1141 in chips) 
Seat 8: Cheburah007 (3207 in chips) 
Seat 9: J_d1nAlt (1139 in chips) 
INISHTE: posts the ante 6
frogz69: posts the ante 6
n00btimer: posts the ante 6
PETROSOO42: posts the ante 6
Caio Mugarte: posts the ante 6
Cheburah007: posts the ante 6
J_d1nAlt: posts the ante 6
Caio Mugarte: posts small blind 25
Cheburah007: posts big blind 50
*** HOLE CARDS ***
Dealt to Caio Mugarte [7c Kd]
J_d1nAlt: folds 
INISHTE: folds 
frogz69: folds 
n00btimer: folds 
PETROSOO42: calls 50
Caio Mugarte: folds 
Cheburah007: checks 
*** FLOP *** [5c 9s Ks]
Cheburah007: checks 
PETROSOO42: checks 
*** TURN *** [5c 9s Ks] [Js]
Cheburah007: bets 50
PETROSOO42: calls 50
*** RIVER *** [5c 9s Ks Js] [Td]
Cheburah007: checks 
PETROSOO42: bets 200
Cheburah007: folds 
Uncalled bet (200) returned to PETROSOO42
PETROSOO42 collected 267 from pot
PETROSOO42: doesn't show hand 
*** SUMMARY ***
Total pot 267 | Rake 0 
Board [5c 9s Ks Js Td]
Seat 1: INISHTE folded before Flop (didn't bet)
Seat 2: frogz69 folded before Flop (didn't bet)
Seat 3: n00btimer folded before Flop (didn't bet)
Seat 4: PETROSOO42 (button) collected (267)
Seat 6: Caio Mugarte (small blind) folded before Flop
Seat 8: Cheburah007 (big blind) folded on the River
Seat 9: J_d1nAlt folded before Flop (didn't bet)



PokerStars Hand #245446859317: Tournament #3632677041, $0.23+$0.02 USD Hold'em No Limit - Level III (25/50) - 2023/08/17 17:52:15 AT [2023/08/17 16:52:15 ET]
Table '3632677041 3' 9-max Seat #6 is the button
Seat 1: INISHTE (868 in chips) 
Seat 2: frogz69 (5070 in chips) 
Seat 3: n00btimer (1562 in chips) 
Seat 4: PETROSOO42 (2101 in chips) 
Seat 6: Caio Mugarte (1110 in chips) 
Seat 8: Cheburah007 (3101 in chips) 
Seat 9: J_d1nAlt (1133 in chips) 
INISHTE: posts the ante 6
frogz69: posts the ante 6
n00btimer: posts the ante 6
PETROSOO42: posts the ante 6
Caio Mugarte: posts the ante 6
Cheburah007: posts the ante 6
J_d1nAlt: posts the ante 6
Cheburah007: posts small blind 25
J_d1nAlt: posts big blind 50
*** HOLE CARDS ***
Dealt to Caio Mugarte [9d Js]
INISHTE: folds 
frogz69: raises 50 to 100
n00btimer: folds 
PETROSOO42: folds 
Caio Mugarte: folds 
Cheburah007: folds 
J_d1nAlt: calls 50
*** FLOP *** [9c 2d Tc]
J_d1nAlt: checks 
frogz69: checks 
*** TURN *** [9c 2d Tc] [6h]
J_d1nAlt: checks 
frogz69: checks 
*** RIVER *** [9c 2d Tc 6h] [8s]
J_d1nAlt: checks 
frogz69: bets 80
J_d1nAlt: folds 
Uncalled bet (80) returned to frogz69
frogz69 collected 267 from pot
frogz69: doesn't show hand 
*** SUMMARY ***
Total pot 267 | Rake 0 
Board [9c 2d Tc 6h 8s]
Seat 1: INISHTE folded before Flop (didn't bet)
Seat 2: frogz69 collected (267)
Seat 3: n00btimer folded before Flop (didn't bet)
Seat 4: PETROSOO42 folded before Flop (didn't bet)
Seat 6: Caio Mugarte (button) folded before Flop (didn't bet)
Seat 8: Cheburah007 (small blind) folded before Flop
Seat 9: J_d1nAlt (big blind) folded on the River



PokerStars Hand #245446880242: Tournament #3632677041, $0.23+$0.02 USD Hold'em No Limit - Level III (25/50) - 2023/08/17 17:53:18 AT [2023/08/17 16:53:18 ET]
Table '3632677041 3' 9-max Seat #8 is the button
Seat 1: INISHTE (862 in chips) 
Seat 2: frogz69 (5231 in chips) 
Seat 3: n00btimer (1556 in chips) 
Seat 4: PETROSOO42 (2095 in chips) 
Seat 6: Caio Mugarte (1104 in chips) 
Seat 8: Cheburah007 (3070 in chips) 
Seat 9: J_d1nAlt (1027 in chips) 
INISHTE: posts the ante 6
frogz69: posts the ante 6
n00btimer: posts the ante 6
PETROSOO42: posts the ante 6
Caio Mugarte: posts the ante 6
Cheburah007: posts the ante 6
J_d1nAlt: posts the ante 6
J_d1nAlt: posts small blind 25
INISHTE: posts big blind 50
*** HOLE CARDS ***
Dealt to Caio Mugarte [Ac Tc]
frogz69: folds 
n00btimer: folds 
PETROSOO42: raises 50 to 100
Caio Mugarte: calls 100
Cheburah007: calls 100
J_d1nAlt: folds 
INISHTE: folds 
*** FLOP *** [Td Th Qc]
PETROSOO42: bets 200
Caio Mugarte: calls 200
Cheburah007: raises 400 to 600
PETROSOO42: calls 400
Caio Mugarte: raises 398 to 998 and is all-in
Cheburah007: calls 398
PETROSOO42: folds 
*** TURN *** [Td Th Qc] [Jd]
*** RIVER *** [Td Th Qc Jd] [7d]
*** SHOW DOWN ***
Caio Mugarte: shows [Ac Tc] (three of a kind, Tens)
Cheburah007: shows [Kc Kh] (two pair, Kings and Tens)
Caio Mugarte collected 3013 from pot
*** SUMMARY ***
Total pot 3013 | Rake 0 
Board [Td Th Qc Jd 7d]
Seat 1: INISHTE (big blind) folded before Flop
Seat 2: frogz69 folded before Flop (didn't bet)
Seat 3: n00btimer folded before Flop (didn't bet)
Seat 4: PETROSOO42 folded on the Flop
Seat 6: Caio Mugarte showed [Ac Tc] and won (3013) with three of a kind, Tens
Seat 8: Cheburah007 (button) showed [Kc Kh] and lost with two pair, Kings and Tens
Seat 9: J_d1nAlt (small blind) folded before Flop



PokerStars Hand #245446903986: Tournament #3632677041, $0.23+$0.02 USD Hold'em No Limit - Level IV (40/80) - 2023/08/17 17:54:29 AT [2023/08/17 16:54:29 ET]
Table '3632677041 3' 9-max Seat #9 is the button
Seat 1: INISHTE (806 in chips) 
Seat 2: frogz69 (5225 in chips) 
Seat 3: n00btimer (1550 in chips) 
Seat 4: PETROSOO42 (1389 in chips) 
Seat 6: Caio Mugarte (3013 in chips) 
Seat 8: Cheburah007 (1966 in chips) 
Seat 9: J_d1nAlt (996 in chips) 
INISHTE: posts the ante 10
frogz69: posts the ante 10
n00btimer: posts the ante 10
PETROSOO42: posts the ante 10
Caio Mugarte: posts the ante 10
Cheburah007: posts the ante 10
J_d1nAlt: posts the ante 10
INISHTE: posts small blind 40
frogz69: posts big blind 80
*** HOLE CARDS ***
Dealt to Caio Mugarte [Ac Kh]
n00btimer: folds 
PETROSOO42: calls 80
Caio Mugarte: raises 200 to 280
Cheburah007: folds 
J_d1nAlt: folds 
INISHTE: folds 
frogz69: calls 200
PETROSOO42: raises 1099 to 1379 and is all-in
Caio Mugarte: raises 1624 to 3003 and is all-in
frogz69: folds 
Uncalled bet (1624) returned to Caio Mugarte
*** FLOP *** [3d 6s 8d]
*** TURN *** [3d 6s 8d] [6c]
*** RIVER *** [3d 6s 8d 6c] [2d]
*** SHOW DOWN ***
PETROSOO42: shows [Kd Jc] (a pair of Sixes)
Caio Mugarte: shows [Ac Kh] (a pair of Sixes - Ace kicker)
Caio Mugarte collected 3148 from pot
PETROSOO42 finished the tournament in 30th place
*** SUMMARY ***
Total pot 3148 | Rake 0 
Board [3d 6s 8d 6c 2d]
Seat 1: INISHTE (small blind) folded before Flop
Seat 2: frogz69 (big blind) folded before Flop
Seat 3: n00btimer folded before Flop (didn't bet)
Seat 4: PETROSOO42 showed [Kd Jc] and lost with a pair of Sixes
Seat 6: Caio Mugarte showed [Ac Kh] and won (3148) with a pair of Sixes
Seat 8: Cheburah007 folded before Flop (didn't bet)
Seat 9: J_d1nAlt (button) folded before Flop (didn't bet)



PokerStars Hand #245447001797: Tournament #3632677041, $0.23+$0.02 USD Hold'em No Limit - Level IV (40/80) - 2023/08/17 18:00:43 AT [2023/08/17 17:00:43 ET]
Table '3632677041 3' 9-max Seat #1 is the button
Seat 1: INISHTE (756 in chips) 
Seat 2: frogz69 (4935 in chips) 
Seat 3: n00btimer (1540 in chips) 
Seat 4: vectra79 (2189 in chips) 
Seat 6: Caio Mugarte (4772 in chips) 
Seat 8: Cheburah007 (1956 in chips) 
Seat 9: J_d1nAlt (986 in chips) 
INISHTE: posts the ante 10
frogz69: posts the ante 10
n00btimer: posts the ante 10
vectra79: posts the ante 10
Caio Mugarte: posts the ante 10
Cheburah007: posts the ante 10
J_d1nAlt: posts the ante 10
frogz69: posts small blind 40
n00btimer: posts big blind 80
*** HOLE CARDS ***
Dealt to Caio Mugarte [Td 9s]
vectra79: folds 
Caio Mugarte: folds 
Cheburah007: folds 
J_d1nAlt: folds 
INISHTE: raises 666 to 746 and is all-in
frogz69: folds 
n00btimer: folds 
Uncalled bet (666) returned to INISHTE
INISHTE collected 270 from pot
INISHTE: doesn't show hand 
*** SUMMARY ***
Total pot 270 | Rake 0 
Seat 1: INISHTE (button) collected (270)
Seat 2: frogz69 (small blind) folded before Flop
Seat 3: n00btimer (big blind) folded before Flop
Seat 4: vectra79 folded before Flop (didn't bet)
Seat 6: Caio Mugarte folded before Flop (didn't bet)
Seat 8: Cheburah007 folded before Flop (didn't bet)
Seat 9: J_d1nAlt folded before Flop (didn't bet)



PokerStars Hand #245447015358: Tournament #3632677041, $0.23+$0.02 USD Hold'em No Limit - Level IV (40/80) - 2023/08/17 18:01:27 AT [2023/08/17 17:01:27 ET]
Table '3632677041 3' 9-max Seat #2 is the button
Seat 1: INISHTE (936 in chips) 
Seat 2: frogz69 (4885 in chips) 
Seat 3: n00btimer (1450 in chips) 
Seat 4: vectra79 (2179 in chips) 
Seat 6: Caio Mugarte (4762 in chips) 
Seat 8: Cheburah007 (1946 in chips) 
Seat 9: J_d1nAlt (976 in chips) 
INISHTE: posts the ante 10
frogz69: posts the ante 10
n00btimer: posts the ante 10
vectra79: posts the ante 10
Caio Mugarte: posts the ante 10
Cheburah007: posts the ante 10
J_d1nAlt: posts the ante 10
n00btimer: posts small blind 40
vectra79: posts big blind 80
*** HOLE CARDS ***
Dealt to Caio Mugarte [Tc 7d]
Caio Mugarte: folds 
Cheburah007: raises 80 to 160
J_d1nAlt: folds 
INISHTE: folds 
frogz69: folds 
n00btimer: folds 
vectra79: folds 
Uncalled bet (80) returned to Cheburah007
Cheburah007 collected 270 from pot
Cheburah007: doesn't show hand 
*** SUMMARY ***
Total pot 270 | Rake 0 
Seat 1: INISHTE folded before Flop (didn't bet)
Seat 2: frogz69 (button) folded before Flop (didn't bet)
Seat 3: n00btimer (small blind) folded before Flop
Seat 4: vectra79 (big blind) folded before Flop
Seat 6: Caio Mugarte folded before Flop (didn't bet)
Seat 8: Cheburah007 collected (270)
Seat 9: J_d1nAlt folded before Flop (didn't bet)



PokerStars Hand #245447021453: Tournament #3632677041, $0.23+$0.02 USD Hold'em No Limit - Level IV (40/80) - 2023/08/17 18:01:46 AT [2023/08/17 17:01:46 ET]
Table '3632677041 3' 9-max Seat #3 is the button
Seat 1: INISHTE (926 in chips) 
Seat 2: frogz69 (4875 in chips) 
Seat 3: n00btimer (1400 in chips) 
Seat 4: vectra79 (2089 in chips) 
Seat 6: Caio Mugarte (4752 in chips) 
Seat 8: Cheburah007 (2126 in chips) 
Seat 9: J_d1nAlt (966 in chips) 
INISHTE: posts the ante 10
frogz69: posts the ante 10
n00btimer: posts the ante 10
vectra79: posts the ante 10
Caio Mugarte: posts the ante 10
Cheburah007: posts the ante 10
J_d1nAlt: posts the ante 10
vectra79: posts small blind 40
Caio Mugarte: posts big blind 80
*** HOLE CARDS ***
Dealt to Caio Mugarte [4d 4h]
Cheburah007: folds 
J_d1nAlt: folds 
INISHTE: folds 
frogz69: folds 
n00btimer: folds 
vectra79: raises 120 to 200
Caio Mugarte: calls 120
*** FLOP *** [Qs Jc Ad]
vectra79: bets 235
Caio Mugarte: folds 
Uncalled bet (235) returned to vectra79
vectra79 collected 470 from pot
*** SUMMARY ***
Total pot 470 | Rake 0 
Board [Qs Jc Ad]
Seat 1: INISHTE folded before Flop (didn't bet)
Seat 2: frogz69 folded before Flop (didn't bet)
Seat 3: n00btimer (button) folded before Flop (didn't bet)
Seat 4: vectra79 (small blind) collected (470)
Seat 6: Caio Mugarte (big blind) folded on the Flop
Seat 8: Cheburah007 folded before Flop (didn't bet)
Seat 9: J_d1nAlt folded before Flop (didn't bet)



PokerStars Hand #245447030825: Tournament #3632677041, $0.23+$0.02 USD Hold'em No Limit - Level IV (40/80) - 2023/08/17 18:02:15 AT [2023/08/17 17:02:15 ET]
Table '3632677041 3' 9-max Seat #4 is the button
Seat 1: INISHTE (916 in chips) 
Seat 2: frogz69 (4865 in chips) 
Seat 3: n00btimer (1390 in chips) 
Seat 4: vectra79 (2349 in chips) 
Seat 6: Caio Mugarte (4542 in chips) 
Seat 8: Cheburah007 (2116 in chips) 
Seat 9: J_d1nAlt (956 in chips) 
INISHTE: posts the ante 10
frogz69: posts the ante 10
n00btimer: posts the ante 10
vectra79: posts the ante 10
Caio Mugarte: posts the ante 10
Cheburah007: posts the ante 10
J_d1nAlt: posts the ante 10
Caio Mugarte: posts small blind 40
Cheburah007: posts big blind 80
*** HOLE CARDS ***
Dealt to Caio Mugarte [9c 2d]
J_d1nAlt: folds 
INISHTE: folds 
frogz69: folds 
n00btimer: folds 
vectra79: raises 120 to 200
Caio Mugarte: folds 
Cheburah007: calls 120
*** FLOP *** [Jc 9h 5s]
Cheburah007: bets 160
vectra79: raises 415 to 575
Cheburah007: raises 1331 to 1906 and is all-in
vectra79: calls 1331
*** TURN *** [Jc 9h 5s] [Ac]
*** RIVER *** [Jc 9h 5s Ac] [2c]
*** SHOW DOWN ***
Cheburah007: shows [Jh Js] (three of a kind, Jacks)
vectra79: shows [Kd Kc] (a pair of Kings)
Cheburah007 collected 4322 from pot
*** SUMMARY ***
Total pot 4322 | Rake 0 
Board [Jc 9h 5s Ac 2c]
Seat 1: INISHTE folded before Flop (didn't bet)
Seat 2: frogz69 folded before Flop (didn't bet)
Seat 3: n00btimer folded before Flop (didn't bet)
Seat 4: vectra79 (button) showed [Kd Kc] and lost with a pair of Kings
Seat 6: Caio Mugarte (small blind) folded before Flop
Seat 8: Cheburah007 (big blind) showed [Jh Js] and won (4322) with three of a kind, Jacks
Seat 9: J_d1nAlt folded before Flop (didn't bet)



PokerStars Hand #245447045423: Tournament #3632677041, $0.23+$0.02 USD Hold'em No Limit - Level IV (40/80) - 2023/08/17 18:02:59 AT [2023/08/17 17:02:59 ET]
Table '3632677041 3' 9-max Seat #6 is the button
Seat 1: INISHTE (906 in chips) 
Seat 2: frogz69 (4855 in chips) 
Seat 3: n00btimer (1380 in chips) 
Seat 4: vectra79 (233 in chips) 
Seat 5: kidritalina (3779 in chips) 
Seat 6: Caio Mugarte (4492 in chips) 
Seat 7: andremelqs (3009 in chips) out of hand (moved from another table into small blind)
Seat 8: Cheburah007 (4322 in chips) 
Seat 9: J_d1nAlt (946 in chips) 
andremelqs will be allowed to play after the button
INISHTE: posts the ante 10
frogz69: posts the ante 10
n00btimer: posts the ante 10
vectra79: posts the ante 10
kidritalina: posts the ante 10
Caio Mugarte: posts the ante 10
Cheburah007: posts the ante 10
J_d1nAlt: posts the ante 10
Cheburah007: posts small blind 40
J_d1nAlt: posts big blind 80
*** HOLE CARDS ***
Dealt to Caio Mugarte [Th 4c]
INISHTE: folds 
frogz69: folds 
n00btimer: folds 
vectra79: raises 143 to 223 and is all-in
kidritalina: folds 
Caio Mugarte: folds 
Cheburah007: calls 183
J_d1nAlt: folds 
*** FLOP *** [Kc 9s As]
*** TURN *** [Kc 9s As] [Ad]
*** RIVER *** [Kc 9s As Ad] [8c]
*** SHOW DOWN ***
Cheburah007: shows [5h 7h] (a pair of Aces)
vectra79: shows [Jh Kh] (two pair, Aces and Kings)
vectra79 collected 606 from pot
*** SUMMARY ***
Total pot 606 | Rake 0 
Board [Kc 9s As Ad 8c]
Seat 1: INISHTE folded before Flop (didn't bet)
Seat 2: frogz69 folded before Flop (didn't bet)
Seat 3: n00btimer folded before Flop (didn't bet)
Seat 4: vectra79 showed [Jh Kh] and won (606) with two pair, Aces and Kings
Seat 5: kidritalina folded before Flop (didn't bet)
Seat 6: Caio Mugarte (button) folded before Flop (didn't bet)
Seat 8: Cheburah007 (small blind) showed [5h 7h] and lost with a pair of Aces
Seat 9: J_d1nAlt (big blind) folded before Flop



PokerStars Hand #245447056663: Tournament #3632677041, $0.23+$0.02 USD Hold'em No Limit - Level IV (40/80) - 2023/08/17 18:03:33 AT [2023/08/17 17:03:33 ET]
Table '3632677041 3' 9-max Seat #8 is the button
Seat 1: INISHTE (896 in chips) 
Seat 2: frogz69 (4845 in chips) 
Seat 3: n00btimer (1370 in chips) 
Seat 4: vectra79 (606 in chips) 
Seat 5: kidritalina (3769 in chips) 
Seat 6: Caio Mugarte (4482 in chips) 
Seat 7: andremelqs (3009 in chips) 
Seat 8: Cheburah007 (4089 in chips) 
Seat 9: J_d1nAlt (856 in chips) 
INISHTE: posts the ante 10
frogz69: posts the ante 10
n00btimer: posts the ante 10
vectra79: posts the ante 10
kidritalina: posts the ante 10
Caio Mugarte: posts the ante 10
andremelqs: posts the ante 10
Cheburah007: posts the ante 10
J_d1nAlt: posts the ante 10
J_d1nAlt: posts small blind 40
INISHTE: posts big blind 80
*** HOLE CARDS ***
Dealt to Caio Mugarte [Js 3d]
frogz69: folds 
n00btimer: folds 
vectra79: folds 
kidritalina: raises 160 to 240
Caio Mugarte: folds 
andremelqs: calls 240
Cheburah007: folds 
J_d1nAlt: raises 606 to 846 and is all-in
INISHTE: folds 
kidritalina: raises 2913 to 3759 and is all-in
andremelqs: folds [6d 6h]
Uncalled bet (2913) returned to kidritalina
*** FLOP *** [Kd 4s 4h]
*** TURN *** [Kd 4s 4h] [7s]
*** RIVER *** [Kd 4s 4h 7s] [Kh]
*** SHOW DOWN ***
J_d1nAlt: shows [8d 8h] (two pair, Kings and Eights)
kidritalina: shows [As Kc] (a full house, Kings full of Fours)
kidritalina collected 2102 from pot
J_d1nAlt finished the tournament in 26th place
*** SUMMARY ***
Total pot 2102 | Rake 0 
Board [Kd 4s 4h 7s Kh]
Seat 1: INISHTE (big blind) folded before Flop
Seat 2: frogz69 folded before Flop (didn't bet)
Seat 3: n00btimer folded before Flop (didn't bet)
Seat 4: vectra79 folded before Flop (didn't bet)
Seat 5: kidritalina showed [As Kc] and won (2102) with a full house, Kings full of Fours
Seat 6: Caio Mugarte folded before Flop (didn't bet)
Seat 7: andremelqs folded before Flop
Seat 8: Cheburah007 (button) folded before Flop (didn't bet)
Seat 9: J_d1nAlt (small blind) showed [8d 8h] and lost with two pair, Kings and Eights



PokerStars Hand #245447071385: Tournament #3632677041, $0.23+$0.02 USD Hold'em No Limit - Level IV (40/80) - 2023/08/17 18:04:17 AT [2023/08/17 17:04:17 ET]
Table '3632677041 3' 9-max Seat #1 is the button
Seat 1: INISHTE (806 in chips) 
Seat 2: frogz69 (4835 in chips) 
Seat 3: n00btimer (1360 in chips) 
Seat 4: vectra79 (596 in chips) 
Seat 5: kidritalina (5015 in chips) 
Seat 6: Caio Mugarte (4472 in chips) 
Seat 7: andremelqs (2759 in chips) 
Seat 8: Cheburah007 (4079 in chips) 
INISHTE: posts the ante 10
frogz69: posts the ante 10
n00btimer: posts the ante 10
vectra79: posts the ante 10
kidritalina: posts the ante 10
Caio Mugarte: posts the ante 10
andremelqs: posts the ante 10
Cheburah007: posts the ante 10
frogz69: posts small blind 40
n00btimer: posts big blind 80
*** HOLE CARDS ***
Dealt to Caio Mugarte [8h 7h]
vectra79: folds 
kidritalina: folds 
Caio Mugarte: folds 
andremelqs: folds 
Cheburah007: calls 80
INISHTE: folds 
frogz69: folds 
n00btimer: checks 
*** FLOP *** [Th 9d 2c]
n00btimer: checks 
Cheburah007: checks 
*** TURN *** [Th 9d 2c] [Jd]
n00btimer: checks 
Cheburah007: bets 140
n00btimer: calls 140
*** RIVER *** [Th 9d 2c Jd] [Tc]
n00btimer: bets 1130 and is all-in
Cheburah007: folds 
Uncalled bet (1130) returned to n00btimer
n00btimer collected 560 from pot
n00btimer: doesn't show hand 
*** SUMMARY ***
Total pot 560 | Rake 0 
Board [Th 9d 2c Jd Tc]
Seat 1: INISHTE (button) folded before Flop (didn't bet)
Seat 2: frogz69 (small blind) folded before Flop
Seat 3: n00btimer (big blind) collected (560)
Seat 4: vectra79 folded before Flop (didn't bet)
Seat 5: kidritalina folded before Flop (didn't bet)
Seat 6: Caio Mugarte folded before Flop (didn't bet)
Seat 7: andremelqs folded before Flop (didn't bet)
Seat 8: Cheburah007 folded on the River



PokerStars Hand #245447097735: Tournament #3632677041, $0.23+$0.02 USD Hold'em No Limit - Level IV (40/80) - 2023/08/17 18:05:35 AT [2023/08/17 17:05:35 ET]
Table '3632677041 3' 9-max Seat #2 is the button
Seat 1: INISHTE (796 in chips) 
Seat 2: frogz69 (4785 in chips) 
Seat 3: n00btimer (1690 in chips) 
Seat 4: vectra79 (586 in chips) 
Seat 5: kidritalina (5005 in chips) 
Seat 6: Caio Mugarte (4462 in chips) 
Seat 7: andremelqs (2749 in chips) 
Seat 8: Cheburah007 (3849 in chips) 
INISHTE: posts the ante 10
frogz69: posts the ante 10
n00btimer: posts the ante 10
vectra79: posts the ante 10
kidritalina: posts the ante 10
Caio Mugarte: posts the ante 10
andremelqs: posts the ante 10
Cheburah007: posts the ante 10
n00btimer: posts small blind 40
vectra79: posts big blind 80
*** HOLE CARDS ***
Dealt to Caio Mugarte [Ac Jh]
kidritalina: folds 
Caio Mugarte: raises 80 to 160
andremelqs: folds 
Cheburah007: folds 
INISHTE: folds 
frogz69: folds 
n00btimer: calls 120
vectra79: calls 80
*** FLOP *** [9d 9s Qh]
n00btimer: checks 
vectra79: bets 416 and is all-in
Caio Mugarte: folds 
n00btimer: folds 
Uncalled bet (416) returned to vectra79
vectra79 collected 560 from pot
*** SUMMARY ***
Total pot 560 | Rake 0 
Board [9d 9s Qh]
Seat 1: INISHTE folded before Flop (didn't bet)
Seat 2: frogz69 (button) folded before Flop (didn't bet)
Seat 3: n00btimer (small blind) folded on the Flop
Seat 4: vectra79 (big blind) collected (560)
Seat 5: kidritalina folded before Flop (didn't bet)
Seat 6: Caio Mugarte folded on the Flop
Seat 7: andremelqs folded before Flop (didn't bet)
Seat 8: Cheburah007 folded before Flop (didn't bet)



PokerStars Hand #245447116436: Tournament #3632677041, $0.23+$0.02 USD Hold'em No Limit - Level IV (40/80) - 2023/08/17 18:06:30 AT [2023/08/17 17:06:30 ET]
Table '3632677041 3' 9-max Seat #3 is the button
Seat 1: INISHTE (786 in chips) 
Seat 2: frogz69 (4775 in chips) 
Seat 3: n00btimer (1520 in chips) 
Seat 4: vectra79 (976 in chips) 
Seat 5: kidritalina (4995 in chips) 
Seat 6: Caio Mugarte (4292 in chips) 
Seat 7: andremelqs (2739 in chips) 
Seat 8: Cheburah007 (3839 in chips) 
INISHTE: posts the ante 10
frogz69: posts the ante 10
n00btimer: posts the ante 10
vectra79: posts the ante 10
kidritalina: posts the ante 10
Caio Mugarte: posts the ante 10
andremelqs: posts the ante 10
Cheburah007: posts the ante 10
vectra79: posts small blind 40
kidritalina: posts big blind 80
*** HOLE CARDS ***
Dealt to Caio Mugarte [Jh Th]
Caio Mugarte: raises 80 to 160
andremelqs: folds 
Cheburah007: calls 160
INISHTE: folds 
frogz69: folds 
n00btimer: folds 
vectra79: folds 
kidritalina: calls 80
*** FLOP *** [Tc 5c Jc]
kidritalina: checks 
Caio Mugarte: bets 198
Cheburah007: folds 
kidritalina: folds 
Uncalled bet (198) returned to Caio Mugarte
Caio Mugarte collected 600 from pot
Caio Mugarte: doesn't show hand 
*** SUMMARY ***
Total pot 600 | Rake 0 
Board [Tc 5c Jc]
Seat 1: INISHTE folded before Flop (didn't bet)
Seat 2: frogz69 folded before Flop (didn't bet)
Seat 3: n00btimer (button) folded before Flop (didn't bet)
Seat 4: vectra79 (small blind) folded before Flop
Seat 5: kidritalina (big blind) folded on the Flop
Seat 6: Caio Mugarte collected (600)
Seat 7: andremelqs folded before Flop (didn't bet)
Seat 8: Cheburah007 folded on the Flop



PokerStars Hand #245447132896: Tournament #3632677041, $0.23+$0.02 USD Hold'em No Limit - Level IV (40/80) - 2023/08/17 18:07:19 AT [2023/08/17 17:07:19 ET]
Table '3632677041 3' 9-max Seat #4 is the button
Seat 1: INISHTE (776 in chips) 
Seat 2: frogz69 (4765 in chips) 
Seat 3: n00btimer (1510 in chips) 
Seat 4: vectra79 (926 in chips) 
Seat 5: kidritalina (4825 in chips) 
Seat 6: Caio Mugarte (4722 in chips) 
Seat 7: andremelqs (2729 in chips) 
Seat 8: Cheburah007 (3669 in chips) 
INISHTE: posts the ante 10
frogz69: posts the ante 10
n00btimer: posts the ante 10
vectra79: posts the ante 10
kidritalina: posts the ante 10
Caio Mugarte: posts the ante 10
andremelqs: posts the ante 10
Cheburah007: posts the ante 10
kidritalina: posts small blind 40
Caio Mugarte: posts big blind 80
*** HOLE CARDS ***
Dealt to Caio Mugarte [Td 5s]
andremelqs: folds 
Cheburah007: folds 
INISHTE: folds 
frogz69: folds 
n00btimer: folds 
vectra79: raises 836 to 916 and is all-in
kidritalina: folds 
Caio Mugarte: folds 
Uncalled bet (836) returned to vectra79
vectra79 collected 280 from pot
*** SUMMARY ***
Total pot 280 | Rake 0 
Seat 1: INISHTE folded before Flop (didn't bet)
Seat 2: frogz69 folded before Flop (didn't bet)
Seat 3: n00btimer folded before Flop (didn't bet)
Seat 4: vectra79 (button) collected (280)
Seat 5: kidritalina (small blind) folded before Flop
Seat 6: Caio Mugarte (big blind) folded before Flop
Seat 7: andremelqs folded before Flop (didn't bet)
Seat 8: Cheburah007 folded before Flop (didn't bet)



PokerStars Hand #245447141132: Tournament #3632677041, $0.23+$0.02 USD Hold'em No Limit - Level IV (40/80) - 2023/08/17 18:07:43 AT [2023/08/17 17:07:43 ET]
Table '3632677041 3' 9-max Seat #5 is the button
Seat 1: INISHTE (766 in chips) 
Seat 2: frogz69 (4755 in chips) 
Seat 3: n00btimer (1500 in chips) 
Seat 4: vectra79 (1116 in chips) 
Seat 5: kidritalina (4775 in chips) 
Seat 6: Caio Mugarte (4632 in chips) 
Seat 7: andremelqs (2719 in chips) 
Seat 8: Cheburah007 (3659 in chips) 
INISHTE: posts the ante 10
frogz69: posts the ante 10
n00btimer: posts the ante 10
vectra79: posts the ante 10
kidritalina: posts the ante 10
Caio Mugarte: posts the ante 10
andremelqs: posts the ante 10
Cheburah007: posts the ante 10
Caio Mugarte: posts small blind 40
andremelqs: posts big blind 80
*** HOLE CARDS ***
Dealt to Caio Mugarte [7c Jc]
Cheburah007: folds 
INISHTE: folds 
frogz69: folds 
n00btimer: folds 
vectra79: folds 
kidritalina: raises 80 to 160
Caio Mugarte: folds 
andremelqs: calls 80
*** FLOP *** [2h Ts Ac]
andremelqs: checks 
kidritalina: bets 440
andremelqs: calls 440
*** TURN *** [2h Ts Ac] [Th]
andremelqs: bets 400
kidritalina: folds 
Uncalled bet (400) returned to andremelqs
andremelqs collected 1320 from pot
*** SUMMARY ***
Total pot 1320 | Rake 0 
Board [2h Ts Ac Th]
Seat 1: INISHTE folded before Flop (didn't bet)
Seat 2: frogz69 folded before Flop (didn't bet)
Seat 3: n00btimer folded before Flop (didn't bet)
Seat 4: vectra79 folded before Flop (didn't bet)
Seat 5: kidritalina (button) folded on the Turn
Seat 6: Caio Mugarte (small blind) folded before Flop
Seat 7: andremelqs (big blind) collected (1320)
Seat 8: Cheburah007 folded before Flop (didn't bet)



PokerStars Hand #245447165082: Tournament #3632677041, $0.23+$0.02 USD Hold'em No Limit - Level IV (40/80) - 2023/08/17 18:08:54 AT [2023/08/17 17:08:54 ET]
Table '3632677041 3' 9-max Seat #6 is the button
Seat 1: INISHTE (756 in chips) 
Seat 2: frogz69 (4745 in chips) 
Seat 3: n00btimer (1490 in chips) 
Seat 4: vectra79 (1106 in chips) 
Seat 5: kidritalina (4165 in chips) 
Seat 6: Caio Mugarte (4582 in chips) 
Seat 7: andremelqs (3429 in chips) 
Seat 8: Cheburah007 (3649 in chips) 
INISHTE: posts the ante 10
frogz69: posts the ante 10
n00btimer: posts the ante 10
vectra79: posts the ante 10
kidritalina: posts the ante 10
Caio Mugarte: posts the ante 10
andremelqs: posts the ante 10
Cheburah007: posts the ante 10
andremelqs: posts small blind 40
Cheburah007: posts big blind 80
*** HOLE CARDS ***
Dealt to Caio Mugarte [3c 4s]
INISHTE: folds 
frogz69: folds 
n00btimer: folds 
vectra79: folds 
kidritalina: calls 80
Caio Mugarte: folds 
andremelqs: calls 40
Cheburah007: checks 
*** FLOP *** [5c 3d Jd]
andremelqs: checks 
Cheburah007: checks 
kidritalina: bets 320
andremelqs: calls 320
Cheburah007: folds 
*** TURN *** [5c 3d Jd] [Jc]
andremelqs: checks 
kidritalina: checks 
*** RIVER *** [5c 3d Jd Jc] [7h]
andremelqs: bets 560
kidritalina: calls 560
*** SHOW DOWN ***
andremelqs: shows [9s Js] (three of a kind, Jacks)
kidritalina: mucks hand 
andremelqs collected 2080 from pot
*** SUMMARY ***
Total pot 2080 | Rake 0 
Board [5c 3d Jd Jc 7h]
Seat 1: INISHTE folded before Flop (didn't bet)
Seat 2: frogz69 folded before Flop (didn't bet)
Seat 3: n00btimer folded before Flop (didn't bet)
Seat 4: vectra79 folded before Flop (didn't bet)
Seat 5: kidritalina mucked [Ad 9d]
Seat 6: Caio Mugarte (button) folded before Flop (didn't bet)
Seat 7: andremelqs (small blind) showed [9s Js] and won (2080) with three of a kind, Jacks
Seat 8: Cheburah007 (big blind) folded on the Flop



PokerStars Hand #245447189238: Tournament #3632677041, $0.23+$0.02 USD Hold'em No Limit - Level V (60/120) - 2023/08/17 18:10:06 AT [2023/08/17 17:10:06 ET]
Table '3632677041 3' 9-max Seat #7 is the button
Seat 1: INISHTE (746 in chips) 
Seat 2: frogz69 (4735 in chips) 
Seat 3: n00btimer (1480 in chips) 
Seat 4: vectra79 (1096 in chips) 
Seat 5: kidritalina (3195 in chips) 
Seat 6: Caio Mugarte (4572 in chips) 
Seat 7: andremelqs (4539 in chips) 
Seat 8: Cheburah007 (3559 in chips) 
INISHTE: posts the ante 15
frogz69: posts the ante 15
n00btimer: posts the ante 15
vectra79: posts the ante 15
kidritalina: posts the ante 15
Caio Mugarte: posts the ante 15
andremelqs: posts the ante 15
Cheburah007: posts the ante 15
Cheburah007: posts small blind 60
INISHTE: posts big blind 120
*** HOLE CARDS ***
Dealt to Caio Mugarte [5c Kh]
frogz69: raises 120 to 240
n00btimer: folds 
vectra79: folds 
kidritalina: raises 2940 to 3180 and is all-in
Caio Mugarte: folds 
andremelqs: folds 
Cheburah007: folds 
INISHTE: folds 
frogz69: calls 2940
*** FLOP *** [9c Qh 2s]
*** TURN *** [9c Qh 2s] [9h]
*** RIVER *** [9c Qh 2s 9h] [9s]
*** SHOW DOWN ***
frogz69: shows [Ks Ad] (three of a kind, Nines)
kidritalina: shows [Js Jh] (a full house, Nines full of Jacks)
kidritalina collected 6660 from pot
*** SUMMARY ***
Total pot 6660 | Rake 0 
Board [9c Qh 2s 9h 9s]
Seat 1: INISHTE (big blind) folded before Flop
Seat 2: frogz69 showed [Ks Ad] and lost with three of a kind, Nines
Seat 3: n00btimer folded before Flop (didn't bet)
Seat 4: vectra79 folded before Flop (didn't bet)
Seat 5: kidritalina showed [Js Jh] and won (6660) with a full house, Nines full of Jacks
Seat 6: Caio Mugarte folded before Flop (didn't bet)
Seat 7: andremelqs (button) folded before Flop (didn't bet)
Seat 8: Cheburah007 (small blind) folded before Flop



PokerStars Hand #245447202263: Tournament #3632677041, $0.23+$0.02 USD Hold'em No Limit - Level V (60/120) - 2023/08/17 18:10:45 AT [2023/08/17 17:10:45 ET]
Table '3632677041 3' 9-max Seat #8 is the button
Seat 1: INISHTE (611 in chips) 
Seat 2: frogz69 (1540 in chips) 
Seat 3: n00btimer (1465 in chips) 
Seat 4: vectra79 (1081 in chips) 
Seat 5: kidritalina (6660 in chips) 
Seat 6: Caio Mugarte (4557 in chips) 
Seat 7: andremelqs (4524 in chips) 
Seat 8: Cheburah007 (3484 in chips) 
INISHTE: posts the ante 15
frogz69: posts the ante 15
n00btimer: posts the ante 15
vectra79: posts the ante 15
kidritalina: posts the ante 15
Caio Mugarte: posts the ante 15
andremelqs: posts the ante 15
Cheburah007: posts the ante 15
INISHTE: posts small blind 60
frogz69: posts big blind 120
*** HOLE CARDS ***
Dealt to Caio Mugarte [Qc Ks]
n00btimer: folds 
vectra79: raises 946 to 1066 and is all-in
kidritalina: folds 
Caio Mugarte: folds 
andremelqs: folds 
Cheburah007: raises 946 to 2012
INISHTE: folds 
frogz69: folds 
Uncalled bet (946) returned to Cheburah007
*** FLOP *** [9d Qs 3h]
*** TURN *** [9d Qs 3h] [4h]
*** RIVER *** [9d Qs 3h 4h] [4s]
*** SHOW DOWN ***
vectra79: shows [As Ad] (two pair, Aces and Fours)
Cheburah007: shows [8c 8h] (two pair, Eights and Fours)
vectra79 collected 2432 from pot
*** SUMMARY ***
Total pot 2432 | Rake 0 
Board [9d Qs 3h 4h 4s]
Seat 1: INISHTE (small blind) folded before Flop
Seat 2: frogz69 (big blind) folded before Flop
Seat 3: n00btimer folded before Flop (didn't bet)
Seat 4: vectra79 showed [As Ad] and won (2432) with two pair, Aces and Fours
Seat 5: kidritalina folded before Flop (didn't bet)
Seat 6: Caio Mugarte folded before Flop (didn't bet)
Seat 7: andremelqs folded before Flop (didn't bet)
Seat 8: Cheburah007 (button) showed [8c 8h] and lost with two pair, Eights and Fours



PokerStars Hand #245447214959: Tournament #3632677041, $0.23+$0.02 USD Hold'em No Limit - Level V (60/120) - 2023/08/17 18:11:23 AT [2023/08/17 17:11:23 ET]
Table '3632677041 3' 9-max Seat #1 is the button
Seat 1: INISHTE (536 in chips) 
Seat 2: frogz69 (1405 in chips) 
Seat 3: n00btimer (1450 in chips) 
Seat 4: vectra79 (2432 in chips) 
Seat 5: kidritalina (6645 in chips) 
Seat 6: Caio Mugarte (4542 in chips) 
Seat 7: andremelqs (4509 in chips) 
Seat 8: Cheburah007 (2403 in chips) 
INISHTE: posts the ante 15
frogz69: posts the ante 15
n00btimer: posts the ante 15
vectra79: posts the ante 15
kidritalina: posts the ante 15
Caio Mugarte: posts the ante 15
andremelqs: posts the ante 15
Cheburah007: posts the ante 15
frogz69: posts small blind 60
n00btimer: posts big blind 120
*** HOLE CARDS ***
Dealt to Caio Mugarte [6d Kd]
vectra79: folds 
kidritalina: folds 
Caio Mugarte: folds 
andremelqs: folds 
Cheburah007: folds 
INISHTE: folds 
frogz69: folds 
Uncalled bet (60) returned to n00btimer
n00btimer collected 240 from pot
n00btimer: doesn't show hand 
*** SUMMARY ***
Total pot 240 | Rake 0 
Seat 1: INISHTE (button) folded before Flop (didn't bet)
Seat 2: frogz69 (small blind) folded before Flop
Seat 3: n00btimer (big blind) collected (240)
Seat 4: vectra79 folded before Flop (didn't bet)
Seat 5: kidritalina folded before Flop (didn't bet)
Seat 6: Caio Mugarte folded before Flop (didn't bet)
Seat 7: andremelqs folded before Flop (didn't bet)
Seat 8: Cheburah007 folded before Flop (didn't bet)



PokerStars Hand #245447221925: Tournament #3632677041, $0.23+$0.02 USD Hold'em No Limit - Level V (60/120) - 2023/08/17 18:11:44 AT [2023/08/17 17:11:44 ET]
Table '3632677041 3' 9-max Seat #2 is the button
Seat 1: INISHTE (521 in chips) 
Seat 2: frogz69 (1330 in chips) 
Seat 3: n00btimer (1615 in chips) 
Seat 4: vectra79 (2417 in chips) 
Seat 5: kidritalina (6630 in chips) 
Seat 6: Caio Mugarte (4527 in chips) 
Seat 7: andremelqs (4494 in chips) 
Seat 8: Cheburah007 (2388 in chips) 
INISHTE: posts the ante 15
frogz69: posts the ante 15
n00btimer: posts the ante 15
vectra79: posts the ante 15
kidritalina: posts the ante 15
Caio Mugarte: posts the ante 15
andremelqs: posts the ante 15
Cheburah007: posts the ante 15
n00btimer: posts small blind 60
vectra79: posts big blind 120
*** HOLE CARDS ***
Dealt to Caio Mugarte [Kc 7c]
kidritalina: folds 
Caio Mugarte: folds 
andremelqs: folds 
Cheburah007: raises 120 to 240
INISHTE: folds 
frogz69: raises 1075 to 1315 and is all-in
n00btimer: folds 
vectra79: folds 
Cheburah007: folds 
Uncalled bet (1075) returned to frogz69
frogz69 collected 780 from pot
frogz69: doesn't show hand 
*** SUMMARY ***
Total pot 780 | Rake 0 
Seat 1: INISHTE folded before Flop (didn't bet)
Seat 2: frogz69 (button) collected (780)
Seat 3: n00btimer (small blind) folded before Flop
Seat 4: vectra79 (big blind) folded before Flop
Seat 5: kidritalina folded before Flop (didn't bet)
Seat 6: Caio Mugarte folded before Flop (didn't bet)
Seat 7: andremelqs folded before Flop (didn't bet)
Seat 8: Cheburah007 folded before Flop



PokerStars Hand #245447235167: Tournament #3632677041, $0.23+$0.02 USD Hold'em No Limit - Level V (60/120) - 2023/08/17 18:12:24 AT [2023/08/17 17:12:24 ET]
Table '3632677041 3' 9-max Seat #3 is the button
Seat 1: INISHTE (506 in chips) 
Seat 2: frogz69 (1855 in chips) 
Seat 3: n00btimer (1540 in chips) 
Seat 4: vectra79 (2282 in chips) 
Seat 5: kidritalina (6615 in chips) 
Seat 6: Caio Mugarte (4512 in chips) 
Seat 7: andremelqs (4479 in chips) 
Seat 8: Cheburah007 (2133 in chips) 
INISHTE: posts the ante 15
frogz69: posts the ante 15
n00btimer: posts the ante 15
vectra79: posts the ante 15
kidritalina: posts the ante 15
Caio Mugarte: posts the ante 15
andremelqs: posts the ante 15
Cheburah007: posts the ante 15
vectra79: posts small blind 60
kidritalina: posts big blind 120
*** HOLE CARDS ***
Dealt to Caio Mugarte [5s Ts]
Caio Mugarte: folds 
andremelqs: folds 
Cheburah007: folds 
INISHTE: folds 
frogz69: folds 
n00btimer: folds 
vectra79: folds 
Uncalled bet (60) returned to kidritalina
kidritalina collected 240 from pot
kidritalina: doesn't show hand 
*** SUMMARY ***
Total pot 240 | Rake 0 
Seat 1: INISHTE folded before Flop (didn't bet)
Seat 2: frogz69 folded before Flop (didn't bet)
Seat 3: n00btimer (button) folded before Flop (didn't bet)
Seat 4: vectra79 (small blind) folded before Flop
Seat 5: kidritalina (big blind) collected (240)
Seat 6: Caio Mugarte folded before Flop (didn't bet)
Seat 7: andremelqs folded before Flop (didn't bet)
Seat 8: Cheburah007 folded before Flop (didn't bet)



PokerStars Hand #245447243212: Tournament #3632677041, $0.23+$0.02 USD Hold'em No Limit - Level V (60/120) - 2023/08/17 18:12:48 AT [2023/08/17 17:12:48 ET]
Table '3632677041 3' 9-max Seat #4 is the button
Seat 1: INISHTE (491 in chips) 
Seat 2: frogz69 (1840 in chips) 
Seat 3: n00btimer (1525 in chips) 
Seat 4: vectra79 (2207 in chips) 
Seat 5: kidritalina (6780 in chips) 
Seat 6: Caio Mugarte (4497 in chips) 
Seat 7: andremelqs (4464 in chips) 
Seat 8: Cheburah007 (2118 in chips) 
INISHTE: posts the ante 15
frogz69: posts the ante 15
n00btimer: posts the ante 15
vectra79: posts the ante 15
kidritalina: posts the ante 15
Caio Mugarte: posts the ante 15
andremelqs: posts the ante 15
Cheburah007: posts the ante 15
kidritalina: posts small blind 60
Caio Mugarte: posts big blind 120
*** HOLE CARDS ***
Dealt to Caio Mugarte [8s 7h]
andremelqs: folds 
Cheburah007: folds 
INISHTE: folds 
frogz69: folds 
n00btimer: folds 
vectra79: folds 
kidritalina: folds 
Uncalled bet (60) returned to Caio Mugarte
Caio Mugarte collected 240 from pot
Caio Mugarte: doesn't show hand 
*** SUMMARY ***
Total pot 240 | Rake 0 
Seat 1: INISHTE folded before Flop (didn't bet)
Seat 2: frogz69 folded before Flop (didn't bet)
Seat 3: n00btimer folded before Flop (didn't bet)
Seat 4: vectra79 (button) folded before Flop (didn't bet)
Seat 5: kidritalina (small blind) folded before Flop
Seat 6: Caio Mugarte (big blind) collected (240)
Seat 7: andremelqs folded before Flop (didn't bet)
Seat 8: Cheburah007 folded before Flop (didn't bet)



PokerStars Hand #245447252734: Tournament #3632677041, $0.23+$0.02 USD Hold'em No Limit - Level V (60/120) - 2023/08/17 18:13:16 AT [2023/08/17 17:13:16 ET]
Table '3632677041 3' 9-max Seat #5 is the button
Seat 1: INISHTE (476 in chips) 
Seat 2: frogz69 (1825 in chips) 
Seat 3: n00btimer (1510 in chips) 
Seat 4: vectra79 (2192 in chips) 
Seat 5: kidritalina (6705 in chips) 
Seat 6: Caio Mugarte (4662 in chips) 
Seat 7: andremelqs (4449 in chips) 
Seat 8: Cheburah007 (2103 in chips) 
INISHTE: posts the ante 15
frogz69: posts the ante 15
n00btimer: posts the ante 15
vectra79: posts the ante 15
kidritalina: posts the ante 15
Caio Mugarte: posts the ante 15
andremelqs: posts the ante 15
Cheburah007: posts the ante 15
Caio Mugarte: posts small blind 60
andremelqs: posts big blind 120
*** HOLE CARDS ***
Dealt to Caio Mugarte [Ad Qd]
Cheburah007: raises 240 to 360
INISHTE: folds 
frogz69: folds 
n00btimer: folds 
vectra79: folds 
kidritalina: folds 
Caio Mugarte: raises 4287 to 4647 and is all-in
andremelqs: folds 
Cheburah007: calls 1728 and is all-in
Uncalled bet (2559) returned to Caio Mugarte
*** FLOP *** [4c 5d Jh]
*** TURN *** [4c 5d Jh] [8c]
*** RIVER *** [4c 5d Jh 8c] [4d]
*** SHOW DOWN ***
Caio Mugarte: shows [Ad Qd] (a pair of Fours)
Cheburah007: shows [Ac Kh] (a pair of Fours - Ace+King kicker)
Cheburah007 collected 4416 from pot
*** SUMMARY ***
Total pot 4416 | Rake 0 
Board [4c 5d Jh 8c 4d]
Seat 1: INISHTE folded before Flop (didn't bet)
Seat 2: frogz69 folded before Flop (didn't bet)
Seat 3: n00btimer folded before Flop (didn't bet)
Seat 4: vectra79 folded before Flop (didn't bet)
Seat 5: kidritalina (button) folded before Flop (didn't bet)
Seat 6: Caio Mugarte (small blind) showed [Ad Qd] and lost with a pair of Fours
Seat 7: andremelqs (big blind) folded before Flop
Seat 8: Cheburah007 showed [Ac Kh] and won (4416) with a pair of Fours



PokerStars Hand #245447264222: Tournament #3632677041, $0.23+$0.02 USD Hold'em No Limit - Level V (60/120) - 2023/08/17 18:13:50 AT [2023/08/17 17:13:50 ET]
Table '3632677041 3' 9-max Seat #6 is the button
Seat 1: INISHTE (461 in chips) 
Seat 2: frogz69 (1810 in chips) 
Seat 4: vectra79 (2177 in chips) 
Seat 5: kidritalina (6690 in chips) 
Seat 6: Caio Mugarte (2559 in chips) 
Seat 7: andremelqs (4314 in chips) 
Seat 8: Cheburah007 (4416 in chips) 
INISHTE: posts the ante 15
frogz69: posts the ante 15
vectra79: posts the ante 15
kidritalina: posts the ante 15
Caio Mugarte: posts the ante 15
andremelqs: posts the ante 15
Cheburah007: posts the ante 15
andremelqs: posts small blind 60
Cheburah007: posts big blind 120
*** HOLE CARDS ***
Dealt to Caio Mugarte [3c Tc]
INISHTE: folds 
frogz69: folds 
vectra79: folds 
kidritalina: folds 
Caio Mugarte: folds 
andremelqs: calls 60
Cheburah007: checks 
*** FLOP *** [7s Jd 9d]
andremelqs: checks 
Cheburah007: bets 120
andremelqs: calls 120
*** TURN *** [7s Jd 9d] [2c]
andremelqs: checks 
Cheburah007: checks 
*** RIVER *** [7s Jd 9d 2c] [4d]
andremelqs: bets 293
Cheburah007: calls 293
*** SHOW DOWN ***
andremelqs: shows [3h Ac] (high card Ace)
Cheburah007: shows [4c 7d] (two pair, Sevens and Fours)
Cheburah007 collected 1171 from pot
*** SUMMARY ***
Total pot 1171 | Rake 0 
Board [7s Jd 9d 2c 4d]
Seat 1: INISHTE folded before Flop (didn't bet)
Seat 2: frogz69 folded before Flop (didn't bet)
Seat 4: vectra79 folded before Flop (didn't bet)
Seat 5: kidritalina folded before Flop (didn't bet)
Seat 6: Caio Mugarte (button) folded before Flop (didn't bet)
Seat 7: andremelqs (small blind) showed [3h Ac] and lost with high card Ace
Seat 8: Cheburah007 (big blind) showed [4c 7d] and won (1171) with two pair, Sevens and Fours



PokerStars Hand #245447293865: Tournament #3632677041, $0.23+$0.02 USD Hold'em No Limit - Level V (60/120) - 2023/08/17 18:15:19 AT [2023/08/17 17:15:19 ET]
Table '3632677041 3' 9-max Seat #7 is the button
Seat 1: INISHTE (446 in chips) 
Seat 2: frogz69 (1795 in chips) 
Seat 4: vectra79 (2162 in chips) 
Seat 5: kidritalina (6675 in chips) 
Seat 6: Caio Mugarte (2544 in chips) 
Seat 7: andremelqs (3766 in chips) 
Seat 8: Cheburah007 (5039 in chips) 
INISHTE: posts the ante 15
frogz69: posts the ante 15
vectra79: posts the ante 15
kidritalina: posts the ante 15
Caio Mugarte: posts the ante 15
andremelqs: posts the ante 15
Cheburah007: posts the ante 15
Cheburah007: posts small blind 60
INISHTE: posts big blind 120
*** HOLE CARDS ***
Dealt to Caio Mugarte [2d Qs]
frogz69: folds 
vectra79: folds 
kidritalina: folds 
Caio Mugarte: folds 
andremelqs: raises 120 to 240
Cheburah007: folds 
INISHTE: folds 
Uncalled bet (120) returned to andremelqs
andremelqs collected 405 from pot
*** SUMMARY ***
Total pot 405 | Rake 0 
Seat 1: INISHTE (big blind) folded before Flop
Seat 2: frogz69 folded before Flop (didn't bet)
Seat 4: vectra79 folded before Flop (didn't bet)
Seat 5: kidritalina folded before Flop (didn't bet)
Seat 6: Caio Mugarte folded before Flop (didn't bet)
Seat 7: andremelqs (button) collected (405)
Seat 8: Cheburah007 (small blind) folded before Flop



PokerStars Hand #245447301204: Tournament #3632677041, $0.23+$0.02 USD Hold'em No Limit - Level V (60/120) - 2023/08/17 18:15:41 AT [2023/08/17 17:15:41 ET]
Table '3632677041 3' 9-max Seat #8 is the button
Seat 1: INISHTE (311 in chips) 
Seat 2: frogz69 (1780 in chips) 
Seat 4: vectra79 (2147 in chips) 
Seat 5: kidritalina (6660 in chips) 
Seat 6: Caio Mugarte (2529 in chips) 
Seat 7: andremelqs (4036 in chips) 
Seat 8: Cheburah007 (4964 in chips) 
INISHTE: posts the ante 15
frogz69: posts the ante 15
vectra79: posts the ante 15
kidritalina: posts the ante 15
Caio Mugarte: posts the ante 15
andremelqs: posts the ante 15
Cheburah007: posts the ante 15
INISHTE: posts small blind 60
frogz69: posts big blind 120
*** HOLE CARDS ***
Dealt to Caio Mugarte [Td Qs]
vectra79: folds 
kidritalina: folds 
Caio Mugarte: folds 
andremelqs: folds 
Cheburah007: folds 
INISHTE: raises 176 to 296 and is all-in
frogz69: folds 
Uncalled bet (176) returned to INISHTE
INISHTE collected 345 from pot
INISHTE: doesn't show hand 
*** SUMMARY ***
Total pot 345 | Rake 0 
Seat 1: INISHTE (small blind) collected (345)
Seat 2: frogz69 (big blind) folded before Flop
Seat 4: vectra79 folded before Flop (didn't bet)
Seat 5: kidritalina folded before Flop (didn't bet)
Seat 6: Caio Mugarte folded before Flop (didn't bet)
Seat 7: andremelqs folded before Flop (didn't bet)
Seat 8: Cheburah007 (button) folded before Flop (didn't bet)



PokerStars Hand #245447308990: Tournament #3632677041, $0.23+$0.02 USD Hold'em No Limit - Level V (60/120) - 2023/08/17 18:16:04 AT [2023/08/17 17:16:04 ET]
Table '3632677041 3' 9-max Seat #1 is the button
Seat 1: INISHTE (521 in chips) 
Seat 2: frogz69 (1645 in chips) 
Seat 4: vectra79 (2132 in chips) 
Seat 5: kidritalina (6645 in chips) 
Seat 6: Caio Mugarte (2514 in chips) 
Seat 7: andremelqs (4021 in chips) 
Seat 8: Cheburah007 (4949 in chips) 
INISHTE: posts the ante 15
frogz69: posts the ante 15
vectra79: posts the ante 15
kidritalina: posts the ante 15
Caio Mugarte: posts the ante 15
andremelqs: posts the ante 15
Cheburah007: posts the ante 15
frogz69: posts small blind 60
vectra79: posts big blind 120
*** HOLE CARDS ***
Dealt to Caio Mugarte [3h Jh]
kidritalina: folds 
Caio Mugarte: folds 
andremelqs: folds 
Cheburah007: raises 120 to 240
INISHTE: folds 
frogz69: raises 1390 to 1630 and is all-in
vectra79: folds 
Cheburah007: folds 
Uncalled bet (1390) returned to frogz69
frogz69 collected 705 from pot
frogz69: doesn't show hand 
*** SUMMARY ***
Total pot 705 | Rake 0 
Seat 1: INISHTE (button) folded before Flop (didn't bet)
Seat 2: frogz69 (small blind) collected (705)
Seat 4: vectra79 (big blind) folded before Flop
Seat 5: kidritalina folded before Flop (didn't bet)
Seat 6: Caio Mugarte folded before Flop (didn't bet)
Seat 7: andremelqs folded before Flop (didn't bet)
Seat 8: Cheburah007 folded before Flop



PokerStars Hand #245447320174: Tournament #3632677041, $0.23+$0.02 USD Hold'em No Limit - Level V (60/120) - 2023/08/17 18:16:37 AT [2023/08/17 17:16:37 ET]
Table '3632677041 3' 9-max Seat #2 is the button
Seat 1: INISHTE (506 in chips) 
Seat 2: frogz69 (2095 in chips) 
Seat 4: vectra79 (1997 in chips) 
Seat 5: kidritalina (6630 in chips) 
Seat 6: Caio Mugarte (2499 in chips) 
Seat 7: andremelqs (4006 in chips) 
Seat 8: Cheburah007 (4694 in chips) 
INISHTE: posts the ante 15
frogz69: posts the ante 15
vectra79: posts the ante 15
kidritalina: posts the ante 15
Caio Mugarte: posts the ante 15
andremelqs: posts the ante 15
Cheburah007: posts the ante 15
vectra79: posts small blind 60
kidritalina: posts big blind 120
*** HOLE CARDS ***
Dealt to Caio Mugarte [Kd Ad]
Caio Mugarte: raises 120 to 240
andremelqs: folds 
Cheburah007: folds 
INISHTE: folds 
frogz69: folds 
vectra79: folds 
kidritalina: folds 
Uncalled bet (120) returned to Caio Mugarte
Caio Mugarte collected 405 from pot
Caio Mugarte: doesn't show hand 
*** SUMMARY ***
Total pot 405 | Rake 0 
Seat 1: INISHTE folded before Flop (didn't bet)
Seat 2: frogz69 (button) folded before Flop (didn't bet)
Seat 4: vectra79 (small blind) folded before Flop
Seat 5: kidritalina (big blind) folded before Flop
Seat 6: Caio Mugarte collected (405)
Seat 7: andremelqs folded before Flop (didn't bet)
Seat 8: Cheburah007 folded before Flop (didn't bet)



PokerStars Hand #245447324702: Tournament #3632677041, $0.23+$0.02 USD Hold'em No Limit - Level V (60/120) - 2023/08/17 18:16:50 AT [2023/08/17 17:16:50 ET]
Table '3632677041 3' 9-max Seat #4 is the button
Seat 1: INISHTE (491 in chips) 
Seat 2: frogz69 (2080 in chips) 
Seat 4: vectra79 (1922 in chips) 
Seat 5: kidritalina (6495 in chips) 
Seat 6: Caio Mugarte (2769 in chips) 
Seat 7: andremelqs (3991 in chips) 
Seat 8: Cheburah007 (4679 in chips) 
INISHTE: posts the ante 15
frogz69: posts the ante 15
vectra79: posts the ante 15
kidritalina: posts the ante 15
Caio Mugarte: posts the ante 15
andremelqs: posts the ante 15
Cheburah007: posts the ante 15
kidritalina: posts small blind 60
Caio Mugarte: posts big blind 120
*** HOLE CARDS ***
Dealt to Caio Mugarte [6c 7c]
andremelqs: folds 
Cheburah007: folds 
INISHTE: folds 
frogz69: folds 
vectra79: folds 
kidritalina: calls 60
Caio Mugarte: checks 
*** FLOP *** [9h Qs Qh]
kidritalina: bets 173
Caio Mugarte: folds 
Uncalled bet (173) returned to kidritalina
kidritalina collected 345 from pot
kidritalina: doesn't show hand 
*** SUMMARY ***
Total pot 345 | Rake 0 
Board [9h Qs Qh]
Seat 1: INISHTE folded before Flop (didn't bet)
Seat 2: frogz69 folded before Flop (didn't bet)
Seat 4: vectra79 (button) folded before Flop (didn't bet)
Seat 5: kidritalina (small blind) collected (345)
Seat 6: Caio Mugarte (big blind) folded on the Flop
Seat 7: andremelqs folded before Flop (didn't bet)
Seat 8: Cheburah007 folded before Flop (didn't bet)



PokerStars Hand #245447332510: Tournament #3632677041, $0.23+$0.02 USD Hold'em No Limit - Level V (60/120) - 2023/08/17 18:17:13 AT [2023/08/17 17:17:13 ET]
Table '3632677041 3' 9-max Seat #5 is the button
Seat 1: INISHTE (476 in chips) 
Seat 2: frogz69 (2065 in chips) 
Seat 4: vectra79 (1907 in chips) 
Seat 5: kidritalina (6705 in chips) 
Seat 6: Caio Mugarte (2634 in chips) 
Seat 7: andremelqs (3976 in chips) 
Seat 8: Cheburah007 (4664 in chips) 
INISHTE: posts the ante 15
frogz69: posts the ante 15
vectra79: posts the ante 15
kidritalina: posts the ante 15
Caio Mugarte: posts the ante 15
andremelqs: posts the ante 15
Cheburah007: posts the ante 15
Caio Mugarte: posts small blind 60
andremelqs: posts big blind 120
*** HOLE CARDS ***
Dealt to Caio Mugarte [8s 3h]
Cheburah007: raises 120 to 240
INISHTE: folds 
frogz69: folds 
vectra79: folds 
kidritalina: calls 240
Caio Mugarte: folds 
andremelqs: calls 120
*** FLOP *** [Kd Th 4c]
andremelqs: checks 
Cheburah007: checks 
kidritalina: bets 885
andremelqs: calls 885
Cheburah007: folds 
*** TURN *** [Kd Th 4c] [2s]
andremelqs: checks 
kidritalina: bets 5565 and is all-in
andremelqs: calls 2836 and is all-in
Uncalled bet (2729) returned to kidritalina
*** RIVER *** [Kd Th 4c 2s] [3d]
*** SHOW DOWN ***
andremelqs: shows [Qc Tc] (a pair of Tens)
kidritalina: shows [Kc As] (a pair of Kings)
kidritalina collected 8327 from pot
andremelqs finished the tournament in 20th place
*** SUMMARY ***
Total pot 8327 | Rake 0 
Board [Kd Th 4c 2s 3d]
Seat 1: INISHTE folded before Flop (didn't bet)
Seat 2: frogz69 folded before Flop (didn't bet)
Seat 4: vectra79 folded before Flop (didn't bet)
Seat 5: kidritalina (button) showed [Kc As] and won (8327) with a pair of Kings
Seat 6: Caio Mugarte (small blind) folded before Flop
Seat 7: andremelqs (big blind) showed [Qc Tc] and lost with a pair of Tens
Seat 8: Cheburah007 folded on the Flop



PokerStars Hand #245447353731: Tournament #3632677041, $0.23+$0.02 USD Hold'em No Limit - Level V (60/120) - 2023/08/17 18:18:16 AT [2023/08/17 17:18:16 ET]
Table '3632677041 3' 9-max Seat #6 is the button
Seat 1: INISHTE (461 in chips) 
Seat 2: frogz69 (2050 in chips) 
Seat 4: vectra79 (1892 in chips) 
Seat 5: kidritalina (11056 in chips) 
Seat 6: Caio Mugarte (2559 in chips) 
Seat 8: Cheburah007 (4409 in chips) 
INISHTE: posts the ante 15
frogz69: posts the ante 15
vectra79: posts the ante 15
kidritalina: posts the ante 15
Caio Mugarte: posts the ante 15
Cheburah007: posts the ante 15
Cheburah007: posts small blind 60
INISHTE: posts big blind 120
*** HOLE CARDS ***
Dealt to Caio Mugarte [2h Qd]
frogz69: raises 120 to 240
vectra79: folds 
kidritalina: folds 
Caio Mugarte: folds 
Cheburah007: folds 
INISHTE: raises 206 to 446 and is all-in
frogz69: calls 206
*** FLOP *** [2s Jh 2c]
*** TURN *** [2s Jh 2c] [Ac]
*** RIVER *** [2s Jh 2c Ac] [4h]
*** SHOW DOWN ***
INISHTE: shows [Qh Kh] (a pair of Deuces)
frogz69: shows [Ah Th] (two pair, Aces and Deuces)
frogz69 collected 1042 from pot
INISHTE finished the tournament in 19th place
*** SUMMARY ***
Total pot 1042 | Rake 0 
Board [2s Jh 2c Ac 4h]
Seat 1: INISHTE (big blind) showed [Qh Kh] and lost with a pair of Deuces
Seat 2: frogz69 showed [Ah Th] and won (1042) with two pair, Aces and Deuces
Seat 4: vectra79 folded before Flop (didn't bet)
Seat 5: kidritalina folded before Flop (didn't bet)
Seat 6: Caio Mugarte (button) folded before Flop (didn't bet)
Seat 8: Cheburah007 (small blind) folded before Flop



PokerStars Hand #245447364440: Tournament #3632677041, $0.23+$0.02 USD Hold'em No Limit - Level V (60/120) - 2023/08/17 18:18:49 AT [2023/08/17 17:18:49 ET]
Table '3632677041 4' 9-max Seat #9 is the button
Seat 1: afsalagoas (814 in chips) 
Seat 2: vectra79 (1877 in chips) 
Seat 3: fmorandi (6485 in chips) 
Seat 4: ErikLarios2836 (1807 in chips) 
Seat 5: Caio Mugarte (2544 in chips) 
Seat 6: kidritalina (11041 in chips) 
Seat 7: rebeLoNrun (2458 in chips) 
Seat 8: lucasveiga20 (2069 in chips) 
Seat 9: TheMagixFlop (2933 in chips) 
afsalagoas: posts the ante 15
vectra79: posts the ante 15
fmorandi: posts the ante 15
ErikLarios2836: posts the ante 15
Caio Mugarte: posts the ante 15
kidritalina: posts the ante 15
rebeLoNrun: posts the ante 15
lucasveiga20: posts the ante 15
TheMagixFlop: posts the ante 15
afsalagoas: posts small blind 60
vectra79: posts big blind 120
*** HOLE CARDS ***
Dealt to Caio Mugarte [3h Jc]
fmorandi: folds 
ErikLarios2836: folds 
Caio Mugarte: folds 
kidritalina: folds 
rebeLoNrun: folds 
lucasveiga20: folds 
TheMagixFlop: folds 
afsalagoas: raises 679 to 799 and is all-in
vectra79: calls 679
*** FLOP *** [3s Th Kh]
*** TURN *** [3s Th Kh] [2h]
*** RIVER *** [3s Th Kh 2h] [Qc]
*** SHOW DOWN ***
afsalagoas: shows [As Ac] (a pair of Aces)
vectra79: shows [9c Ad] (high card Ace)
afsalagoas collected 1733 from pot
*** SUMMARY ***
Total pot 1733 | Rake 0 
Board [3s Th Kh 2h Qc]
Seat 1: afsalagoas (small blind) showed [As Ac] and won (1733) with a pair of Aces
Seat 2: vectra79 (big blind) showed [9c Ad] and lost with high card Ace
Seat 3: fmorandi folded before Flop (didn't bet)
Seat 4: ErikLarios2836 folded before Flop (didn't bet)
Seat 5: Caio Mugarte folded before Flop (didn't bet)
Seat 6: kidritalina folded before Flop (didn't bet)
Seat 7: rebeLoNrun folded before Flop (didn't bet)
Seat 8: lucasveiga20 folded before Flop (didn't bet)
Seat 9: TheMagixFlop (button) folded before Flop (didn't bet)



PokerStars Hand #245447377437: Tournament #3632677041, $0.23+$0.02 USD Hold'em No Limit - Level V (60/120) - 2023/08/17 18:19:28 AT [2023/08/17 17:19:28 ET]
Table '3632677041 4' 9-max Seat #1 is the button
Seat 1: afsalagoas (1733 in chips) 
Seat 2: vectra79 (1063 in chips) 
Seat 3: fmorandi (6470 in chips) 
Seat 4: ErikLarios2836 (1792 in chips) 
Seat 5: Caio Mugarte (2529 in chips) 
Seat 6: kidritalina (11026 in chips) 
Seat 7: rebeLoNrun (2443 in chips) 
Seat 8: lucasveiga20 (2054 in chips) 
Seat 9: TheMagixFlop (2918 in chips) 
afsalagoas: posts the ante 15
vectra79: posts the ante 15
fmorandi: posts the ante 15
ErikLarios2836: posts the ante 15
Caio Mugarte: posts the ante 15
kidritalina: posts the ante 15
rebeLoNrun: posts the ante 15
lucasveiga20: posts the ante 15
TheMagixFlop: posts the ante 15
vectra79: posts small blind 60
fmorandi: posts big blind 120
*** HOLE CARDS ***
Dealt to Caio Mugarte [4s 3d]
ErikLarios2836: folds 
Caio Mugarte: folds 
kidritalina: folds 
rebeLoNrun: folds 
lucasveiga20: folds 
TheMagixFlop: raises 120 to 240
afsalagoas: raises 1478 to 1718 and is all-in
vectra79: folds 
fmorandi: folds 
TheMagixFlop: folds 
Uncalled bet (1478) returned to afsalagoas
afsalagoas collected 795 from pot
afsalagoas: doesn't show hand 
*** SUMMARY ***
Total pot 795 | Rake 0 
Seat 1: afsalagoas (button) collected (795)
Seat 2: vectra79 (small blind) folded before Flop
Seat 3: fmorandi (big blind) folded before Flop
Seat 4: ErikLarios2836 folded before Flop (didn't bet)
Seat 5: Caio Mugarte folded before Flop (didn't bet)
Seat 6: kidritalina folded before Flop (didn't bet)
Seat 7: rebeLoNrun folded before Flop (didn't bet)
Seat 8: lucasveiga20 folded before Flop (didn't bet)
Seat 9: TheMagixFlop folded before Flop



PokerStars Hand #245447388040: Tournament #3632677041, $0.23+$0.02 USD Hold'em No Limit - Level VI (80/160) - 2023/08/17 18:20:00 AT [2023/08/17 17:20:00 ET]
Table '3632677041 4' 9-max Seat #2 is the button
Seat 1: afsalagoas (2273 in chips) 
Seat 2: vectra79 (988 in chips) 
Seat 3: fmorandi (6335 in chips) 
Seat 4: ErikLarios2836 (1777 in chips) 
Seat 5: Caio Mugarte (2514 in chips) 
Seat 6: kidritalina (11011 in chips) 
Seat 7: rebeLoNrun (2428 in chips) 
Seat 8: lucasveiga20 (2039 in chips) 
Seat 9: TheMagixFlop (2663 in chips) 
afsalagoas: posts the ante 20
vectra79: posts the ante 20
fmorandi: posts the ante 20
ErikLarios2836: posts the ante 20
Caio Mugarte: posts the ante 20
kidritalina: posts the ante 20
rebeLoNrun: posts the ante 20
lucasveiga20: posts the ante 20
TheMagixFlop: posts the ante 20
fmorandi: posts small blind 80
ErikLarios2836: posts big blind 160
*** HOLE CARDS ***
Dealt to Caio Mugarte [6c 3d]
Caio Mugarte: folds 
kidritalina: folds 
rebeLoNrun: folds 
lucasveiga20: folds 
TheMagixFlop: folds 
afsalagoas: folds 
vectra79: folds 
fmorandi: raises 160 to 320
ErikLarios2836: calls 160
*** FLOP *** [5d Td Qc]
fmorandi: checks 
ErikLarios2836: checks 
*** TURN *** [5d Td Qc] [As]
fmorandi: checks 
ErikLarios2836: checks 
*** RIVER *** [5d Td Qc As] [2d]
fmorandi: bets 820
ErikLarios2836: folds 
Uncalled bet (820) returned to fmorandi
fmorandi collected 820 from pot
*** SUMMARY ***
Total pot 820 | Rake 0 
Board [5d Td Qc As 2d]
Seat 1: afsalagoas folded before Flop (didn't bet)
Seat 2: vectra79 (button) folded before Flop (didn't bet)
Seat 3: fmorandi (small blind) collected (820)
Seat 4: ErikLarios2836 (big blind) folded on the River
Seat 5: Caio Mugarte folded before Flop (didn't bet)
Seat 6: kidritalina folded before Flop (didn't bet)
Seat 7: rebeLoNrun folded before Flop (didn't bet)
Seat 8: lucasveiga20 folded before Flop (didn't bet)
Seat 9: TheMagixFlop folded before Flop (didn't bet)



PokerStars Hand #245447406574: Tournament #3632677041, $0.23+$0.02 USD Hold'em No Limit - Level VI (80/160) - 2023/08/17 18:20:57 AT [2023/08/17 17:20:57 ET]
Table '3632677041 4' 9-max Seat #3 is the button
Seat 1: afsalagoas (2253 in chips) 
Seat 2: vectra79 (968 in chips) 
Seat 3: fmorandi (6815 in chips) 
Seat 4: ErikLarios2836 (1437 in chips) 
Seat 5: Caio Mugarte (2494 in chips) 
Seat 6: kidritalina (10991 in chips) 
Seat 7: rebeLoNrun (2408 in chips) 
Seat 8: lucasveiga20 (2019 in chips) 
Seat 9: TheMagixFlop (2643 in chips) 
afsalagoas: posts the ante 20
vectra79: posts the ante 20
fmorandi: posts the ante 20
ErikLarios2836: posts the ante 20
Caio Mugarte: posts the ante 20
kidritalina: posts the ante 20
rebeLoNrun: posts the ante 20
lucasveiga20: posts the ante 20
TheMagixFlop: posts the ante 20
ErikLarios2836: posts small blind 80
Caio Mugarte: posts big blind 160
*** HOLE CARDS ***
Dealt to Caio Mugarte [5c Ks]
kidritalina: folds 
rebeLoNrun: folds 
lucasveiga20: raises 1839 to 1999 and is all-in
TheMagixFlop: folds 
afsalagoas: folds 
vectra79: folds 
fmorandi: folds 
ErikLarios2836: folds 
Caio Mugarte: folds 
Uncalled bet (1839) returned to lucasveiga20
lucasveiga20 collected 580 from pot
lucasveiga20: doesn't show hand 
*** SUMMARY ***
Total pot 580 | Rake 0 
Seat 1: afsalagoas folded before Flop (didn't bet)
Seat 2: vectra79 folded before Flop (didn't bet)
Seat 3: fmorandi (button) folded before Flop (didn't bet)
Seat 4: ErikLarios2836 (small blind) folded before Flop
Seat 5: Caio Mugarte (big blind) folded before Flop
Seat 6: kidritalina folded before Flop (didn't bet)
Seat 7: rebeLoNrun folded before Flop (didn't bet)
Seat 8: lucasveiga20 collected (580)
Seat 9: TheMagixFlop folded before Flop (didn't bet)



PokerStars Hand #245447417637: Tournament #3632677041, $0.23+$0.02 USD Hold'em No Limit - Level VI (80/160) - 2023/08/17 18:21:31 AT [2023/08/17 17:21:31 ET]
Table '3632677041 4' 9-max Seat #4 is the button
Seat 1: afsalagoas (2233 in chips) 
Seat 2: vectra79 (948 in chips) 
Seat 3: fmorandi (6795 in chips) 
Seat 4: ErikLarios2836 (1337 in chips) 
Seat 5: Caio Mugarte (2314 in chips) 
Seat 6: kidritalina (10971 in chips) 
Seat 7: rebeLoNrun (2388 in chips) 
Seat 8: lucasveiga20 (2419 in chips) 
Seat 9: TheMagixFlop (2623 in chips) 
afsalagoas: posts the ante 20
vectra79: posts the ante 20
fmorandi: posts the ante 20
ErikLarios2836: posts the ante 20
Caio Mugarte: posts the ante 20
kidritalina: posts the ante 20
rebeLoNrun: posts the ante 20
lucasveiga20: posts the ante 20
TheMagixFlop: posts the ante 20
Caio Mugarte: posts small blind 80
kidritalina: posts big blind 160
*** HOLE CARDS ***
Dealt to Caio Mugarte [8h Kc]
rebeLoNrun: folds 
lucasveiga20: raises 160 to 320
TheMagixFlop: folds 
afsalagoas: folds 
vectra79: folds 
fmorandi: folds 
ErikLarios2836: folds 
Caio Mugarte: folds 
kidritalina: calls 160
*** FLOP *** [9d Jh 9s]
kidritalina: bets 450
lucasveiga20: calls 450
*** TURN *** [9d Jh 9s] [Ac]
kidritalina: checks 
lucasveiga20: checks 
*** RIVER *** [9d Jh 9s Ac] [3s]
kidritalina: checks 
lucasveiga20: bets 828
kidritalina: folds 
Uncalled bet (828) returned to lucasveiga20
lucasveiga20 collected 1800 from pot
lucasveiga20: doesn't show hand 
*** SUMMARY ***
Total pot 1800 | Rake 0 
Board [9d Jh 9s Ac 3s]
Seat 1: afsalagoas folded before Flop (didn't bet)
Seat 2: vectra79 folded before Flop (didn't bet)
Seat 3: fmorandi folded before Flop (didn't bet)
Seat 4: ErikLarios2836 (button) folded before Flop (didn't bet)
Seat 5: Caio Mugarte (small blind) folded before Flop
Seat 6: kidritalina (big blind) folded on the River
Seat 7: rebeLoNrun folded before Flop (didn't bet)
Seat 8: lucasveiga20 collected (1800)
Seat 9: TheMagixFlop folded before Flop (didn't bet)



PokerStars Hand #245447434324: Tournament #3632677041, $0.23+$0.02 USD Hold'em No Limit - Level VI (80/160) - 2023/08/17 18:22:22 AT [2023/08/17 17:22:22 ET]
Table '3632677041 4' 9-max Seat #5 is the button
Seat 1: afsalagoas (2213 in chips) 
Seat 2: vectra79 (928 in chips) 
Seat 3: fmorandi (6775 in chips) 
Seat 4: ErikLarios2836 (1317 in chips) 
Seat 5: Caio Mugarte (2214 in chips) 
Seat 6: kidritalina (10181 in chips) 
Seat 7: rebeLoNrun (2368 in chips) 
Seat 8: lucasveiga20 (3429 in chips) 
Seat 9: TheMagixFlop (2603 in chips) 
afsalagoas: posts the ante 20
vectra79: posts the ante 20
fmorandi: posts the ante 20
ErikLarios2836: posts the ante 20
Caio Mugarte: posts the ante 20
kidritalina: posts the ante 20
rebeLoNrun: posts the ante 20
lucasveiga20: posts the ante 20
TheMagixFlop: posts the ante 20
kidritalina: posts small blind 80
rebeLoNrun: posts big blind 160
*** HOLE CARDS ***
Dealt to Caio Mugarte [5d 5h]
lucasveiga20: raises 160 to 320
TheMagixFlop: folds 
afsalagoas: raises 1873 to 2193 and is all-in
vectra79: folds 
fmorandi: folds 
ErikLarios2836: folds 
Caio Mugarte: folds 
kidritalina: folds 
rebeLoNrun: folds 
lucasveiga20: calls 1873
*** FLOP *** [9s As Tc]
*** TURN *** [9s As Tc] [3d]
*** RIVER *** [9s As Tc 3d] [4c]
*** SHOW DOWN ***
lucasveiga20: shows [Kh Kc] (a pair of Kings)
afsalagoas: shows [Qs Qd] (a pair of Queens)
lucasveiga20 collected 4806 from pot
afsalagoas finished the tournament in 18th place
*** SUMMARY ***
Total pot 4806 | Rake 0 
Board [9s As Tc 3d 4c]
Seat 1: afsalagoas showed [Qs Qd] and lost with a pair of Queens
Seat 2: vectra79 folded before Flop (didn't bet)
Seat 3: fmorandi folded before Flop (didn't bet)
Seat 4: ErikLarios2836 folded before Flop (didn't bet)
Seat 5: Caio Mugarte (button) folded before Flop (didn't bet)
Seat 6: kidritalina (small blind) folded before Flop
Seat 7: rebeLoNrun (big blind) folded before Flop
Seat 8: lucasveiga20 showed [Kh Kc] and won (4806) with a pair of Kings
Seat 9: TheMagixFlop folded before Flop (didn't bet)



PokerStars Hand #245447446105: Tournament #3632677041, $0.23+$0.02 USD Hold'em No Limit - Level VI (80/160) - 2023/08/17 18:22:57 AT [2023/08/17 17:22:57 ET]
Table '3632677041 4' 9-max Seat #6 is the button
Seat 2: vectra79 (908 in chips) 
Seat 3: fmorandi (6755 in chips) 
Seat 4: ErikLarios2836 (1297 in chips) 
Seat 5: Caio Mugarte (2194 in chips) 
Seat 6: kidritalina (10081 in chips) 
Seat 7: rebeLoNrun (2188 in chips) 
Seat 8: lucasveiga20 (6022 in chips) 
Seat 9: TheMagixFlop (2583 in chips) 
vectra79: posts the ante 20
fmorandi: posts the ante 20
ErikLarios2836: posts the ante 20
Caio Mugarte: posts the ante 20
kidritalina: posts the ante 20
rebeLoNrun: posts the ante 20
lucasveiga20: posts the ante 20
TheMagixFlop: posts the ante 20
rebeLoNrun: posts small blind 80
lucasveiga20: posts big blind 160
*** HOLE CARDS ***
Dealt to Caio Mugarte [3s 7s]
TheMagixFlop: folds 
vectra79: raises 728 to 888 and is all-in
fmorandi: folds 
ErikLarios2836: folds 
Caio Mugarte: folds 
kidritalina: calls 888
rebeLoNrun: folds 
lucasveiga20: folds 
*** FLOP *** [6c Ks Qh]
*** TURN *** [6c Ks Qh] [Qs]
*** RIVER *** [6c Ks Qh Qs] [Kd]
*** SHOW DOWN ***
vectra79: shows [6d 6h] (a full house, Sixes full of Kings)
kidritalina: shows [7d 8d] (two pair, Kings and Queens)
vectra79 collected 2176 from pot
*** SUMMARY ***
Total pot 2176 | Rake 0 
Board [6c Ks Qh Qs Kd]
Seat 2: vectra79 showed [6d 6h] and won (2176) with a full house, Sixes full of Kings
Seat 3: fmorandi folded before Flop (didn't bet)
Seat 4: ErikLarios2836 folded before Flop (didn't bet)
Seat 5: Caio Mugarte folded before Flop (didn't bet)
Seat 6: kidritalina (button) showed [7d 8d] and lost with two pair, Kings and Queens
Seat 7: rebeLoNrun (small blind) folded before Flop
Seat 8: lucasveiga20 (big blind) folded before Flop
Seat 9: TheMagixFlop folded before Flop (didn't bet)



PokerStars Hand #245447455383: Tournament #3632677041, $0.23+$0.02 USD Hold'em No Limit - Level VI (80/160) - 2023/08/17 18:23:26 AT [2023/08/17 17:23:26 ET]
Table '3632677041 4' 9-max Seat #7 is the button
Seat 2: vectra79 (2176 in chips) 
Seat 3: fmorandi (6735 in chips) 
Seat 4: ErikLarios2836 (1277 in chips) 
Seat 5: Caio Mugarte (2174 in chips) 
Seat 6: kidritalina (9173 in chips) 
Seat 7: rebeLoNrun (2088 in chips) 
Seat 8: lucasveiga20 (5842 in chips) 
Seat 9: TheMagixFlop (2563 in chips) 
vectra79: posts the ante 20
fmorandi: posts the ante 20
ErikLarios2836: posts the ante 20
Caio Mugarte: posts the ante 20
kidritalina: posts the ante 20
rebeLoNrun: posts the ante 20
lucasveiga20: posts the ante 20
TheMagixFlop: posts the ante 20
lucasveiga20: posts small blind 80
TheMagixFlop: posts big blind 160
*** HOLE CARDS ***
Dealt to Caio Mugarte [5c 6s]
vectra79: folds 
fmorandi: raises 160 to 320
ErikLarios2836: folds 
Caio Mugarte: folds 
kidritalina: folds 
rebeLoNrun: folds 
lucasveiga20: folds 
TheMagixFlop: folds 
Uncalled bet (160) returned to fmorandi
fmorandi collected 560 from pot
*** SUMMARY ***
Total pot 560 | Rake 0 
Seat 2: vectra79 folded before Flop (didn't bet)
Seat 3: fmorandi collected (560)
Seat 4: ErikLarios2836 folded before Flop (didn't bet)
Seat 5: Caio Mugarte folded before Flop (didn't bet)
Seat 6: kidritalina folded before Flop (didn't bet)
Seat 7: rebeLoNrun (button) folded before Flop (didn't bet)
Seat 8: lucasveiga20 (small blind) folded before Flop
Seat 9: TheMagixFlop (big blind) folded before Flop



PokerStars Hand #245447462388: Tournament #3632677041, $0.23+$0.02 USD Hold'em No Limit - Level VI (80/160) - 2023/08/17 18:23:47 AT [2023/08/17 17:23:47 ET]
Table '3632677041 4' 9-max Seat #8 is the button
Seat 2: vectra79 (2156 in chips) 
Seat 3: fmorandi (7115 in chips) 
Seat 4: ErikLarios2836 (1257 in chips) 
Seat 5: Caio Mugarte (2154 in chips) 
Seat 6: kidritalina (9153 in chips) 
Seat 7: rebeLoNrun (2068 in chips) 
Seat 8: lucasveiga20 (5742 in chips) 
Seat 9: TheMagixFlop (2383 in chips) 
vectra79: posts the ante 20
fmorandi: posts the ante 20
ErikLarios2836: posts the ante 20
Caio Mugarte: posts the ante 20
kidritalina: posts the ante 20
rebeLoNrun: posts the ante 20
lucasveiga20: posts the ante 20
TheMagixFlop: posts the ante 20
TheMagixFlop: posts small blind 80
vectra79: posts big blind 160
*** HOLE CARDS ***
Dealt to Caio Mugarte [9h Kd]
fmorandi: folds 
ErikLarios2836: raises 1077 to 1237 and is all-in
Caio Mugarte: folds 
kidritalina: folds 
rebeLoNrun: folds 
lucasveiga20: folds 
TheMagixFlop: folds 
vectra79: folds 
Uncalled bet (1077) returned to ErikLarios2836
ErikLarios2836 collected 560 from pot
ErikLarios2836: doesn't show hand 
*** SUMMARY ***
Total pot 560 | Rake 0 
Seat 2: vectra79 (big blind) folded before Flop
Seat 3: fmorandi folded before Flop (didn't bet)
Seat 4: ErikLarios2836 collected (560)
Seat 5: Caio Mugarte folded before Flop (didn't bet)
Seat 6: kidritalina folded before Flop (didn't bet)
Seat 7: rebeLoNrun folded before Flop (didn't bet)
Seat 8: lucasveiga20 (button) folded before Flop (didn't bet)
Seat 9: TheMagixFlop (small blind) folded before Flop



PokerStars Hand #245447473075: Tournament #3632677041, $0.23+$0.02 USD Hold'em No Limit - Level VI (80/160) - 2023/08/17 18:24:20 AT [2023/08/17 17:24:20 ET]
Table '3632677041 4' 9-max Seat #9 is the button
Seat 2: vectra79 (1976 in chips) 
Seat 3: fmorandi (7095 in chips) 
Seat 4: ErikLarios2836 (1637 in chips) 
Seat 5: Caio Mugarte (2134 in chips) 
Seat 6: kidritalina (9133 in chips) 
Seat 7: rebeLoNrun (2048 in chips) 
Seat 8: lucasveiga20 (5722 in chips) 
Seat 9: TheMagixFlop (2283 in chips) 
vectra79: posts the ante 20
fmorandi: posts the ante 20
ErikLarios2836: posts the ante 20
Caio Mugarte: posts the ante 20
kidritalina: posts the ante 20
rebeLoNrun: posts the ante 20
lucasveiga20: posts the ante 20
TheMagixFlop: posts the ante 20
vectra79: posts small blind 80
fmorandi: posts big blind 160
*** HOLE CARDS ***
Dealt to Caio Mugarte [Ks Ts]
ErikLarios2836: folds 
Caio Mugarte: folds 
kidritalina: raises 8953 to 9113 and is all-in
rebeLoNrun: folds 
lucasveiga20: folds 
TheMagixFlop: folds 
vectra79: folds 
fmorandi: folds 
Uncalled bet (8953) returned to kidritalina
kidritalina collected 560 from pot
kidritalina: doesn't show hand 
*** SUMMARY ***
Total pot 560 | Rake 0 
Seat 2: vectra79 (small blind) folded before Flop
Seat 3: fmorandi (big blind) folded before Flop
Seat 4: ErikLarios2836 folded before Flop (didn't bet)
Seat 5: Caio Mugarte folded before Flop (didn't bet)
Seat 6: kidritalina collected (560)
Seat 7: rebeLoNrun folded before Flop (didn't bet)
Seat 8: lucasveiga20 folded before Flop (didn't bet)
Seat 9: TheMagixFlop (button) folded before Flop (didn't bet)



PokerStars Hand #245447482373: Tournament #3632677041, $0.23+$0.02 USD Hold'em No Limit - Level VI (80/160) - 2023/08/17 18:24:48 AT [2023/08/17 17:24:48 ET]
Table '3632677041 4' 9-max Seat #2 is the button
Seat 2: vectra79 (1876 in chips) 
Seat 3: fmorandi (6915 in chips) 
Seat 4: ErikLarios2836 (1617 in chips) 
Seat 5: Caio Mugarte (2114 in chips) 
Seat 6: kidritalina (9513 in chips) 
Seat 7: rebeLoNrun (2028 in chips) 
Seat 8: lucasveiga20 (5702 in chips) 
Seat 9: TheMagixFlop (2263 in chips) 
vectra79: posts the ante 20
fmorandi: posts the ante 20
ErikLarios2836: posts the ante 20
Caio Mugarte: posts the ante 20
kidritalina: posts the ante 20
rebeLoNrun: posts the ante 20
lucasveiga20: posts the ante 20
TheMagixFlop: posts the ante 20
fmorandi: posts small blind 80
ErikLarios2836: posts big blind 160
*** HOLE CARDS ***
Dealt to Caio Mugarte [3h Qc]
Caio Mugarte: folds 
kidritalina: folds 
rebeLoNrun: folds 
lucasveiga20: folds 
TheMagixFlop: folds 
vectra79: folds 
fmorandi: calls 80
ErikLarios2836: checks 
*** FLOP *** [4h 4d 2c]
fmorandi: bets 160
ErikLarios2836: folds 
Uncalled bet (160) returned to fmorandi
fmorandi collected 480 from pot
*** SUMMARY ***
Total pot 480 | Rake 0 
Board [4h 4d 2c]
Seat 2: vectra79 (button) folded before Flop (didn't bet)
Seat 3: fmorandi (small blind) collected (480)
Seat 4: ErikLarios2836 (big blind) folded on the Flop
Seat 5: Caio Mugarte folded before Flop (didn't bet)
Seat 6: kidritalina folded before Flop (didn't bet)
Seat 7: rebeLoNrun folded before Flop (didn't bet)
Seat 8: lucasveiga20 folded before Flop (didn't bet)
Seat 9: TheMagixFlop folded before Flop (didn't bet)



PokerStars Hand #245447494958: Tournament #3632677041, $0.23+$0.02 USD Hold'em No Limit - Level VI (80/160) - 2023/08/17 18:25:26 AT [2023/08/17 17:25:26 ET]
Table '3632677041 4' 9-max Seat #3 is the button
Seat 2: vectra79 (1856 in chips) 
Seat 3: fmorandi (7215 in chips) 
Seat 4: ErikLarios2836 (1437 in chips) 
Seat 5: Caio Mugarte (2094 in chips) 
Seat 6: kidritalina (9493 in chips) 
Seat 7: rebeLoNrun (2008 in chips) 
Seat 8: lucasveiga20 (5682 in chips) 
Seat 9: TheMagixFlop (2243 in chips) 
vectra79: posts the ante 20
fmorandi: posts the ante 20
ErikLarios2836: posts the ante 20
Caio Mugarte: posts the ante 20
kidritalina: posts the ante 20
rebeLoNrun: posts the ante 20
lucasveiga20: posts the ante 20
TheMagixFlop: posts the ante 20
ErikLarios2836: posts small blind 80
Caio Mugarte: posts big blind 160
*** HOLE CARDS ***
Dealt to Caio Mugarte [4c 2s]
kidritalina: folds 
rebeLoNrun: raises 1828 to 1988 and is all-in
lucasveiga20: folds 
TheMagixFlop: folds 
vectra79: folds 
fmorandi: folds 
ErikLarios2836: folds 
Caio Mugarte: folds 
Uncalled bet (1828) returned to rebeLoNrun
rebeLoNrun collected 560 from pot
*** SUMMARY ***
Total pot 560 | Rake 0 
Seat 2: vectra79 folded before Flop (didn't bet)
Seat 3: fmorandi (button) folded before Flop (didn't bet)
Seat 4: ErikLarios2836 (small blind) folded before Flop
Seat 5: Caio Mugarte (big blind) folded before Flop
Seat 6: kidritalina folded before Flop (didn't bet)
Seat 7: rebeLoNrun collected (560)
Seat 8: lucasveiga20 folded before Flop (didn't bet)
Seat 9: TheMagixFlop folded before Flop (didn't bet)



PokerStars Hand #245447502070: Tournament #3632677041, $0.23+$0.02 USD Hold'em No Limit - Level VI (80/160) - 2023/08/17 18:25:48 AT [2023/08/17 17:25:48 ET]
Table '3632677041 4' 9-max Seat #4 is the button
Seat 2: vectra79 (1836 in chips) 
Seat 3: fmorandi (7195 in chips) 
Seat 4: ErikLarios2836 (1337 in chips) 
Seat 5: Caio Mugarte (1914 in chips) 
Seat 6: kidritalina (9473 in chips) 
Seat 7: rebeLoNrun (2388 in chips) 
Seat 8: lucasveiga20 (5662 in chips) 
Seat 9: TheMagixFlop (2223 in chips) 
vectra79: posts the ante 20
fmorandi: posts the ante 20
ErikLarios2836: posts the ante 20
Caio Mugarte: posts the ante 20
kidritalina: posts the ante 20
rebeLoNrun: posts the ante 20
lucasveiga20: posts the ante 20
TheMagixFlop: posts the ante 20
Caio Mugarte: posts small blind 80
kidritalina: posts big blind 160
*** HOLE CARDS ***
Dealt to Caio Mugarte [8c 2h]
rebeLoNrun: folds 
lucasveiga20: folds 
TheMagixFlop: folds 
vectra79: folds 
fmorandi: calls 160
ErikLarios2836: folds 
Caio Mugarte: folds 
kidritalina: checks 
*** FLOP *** [Jh 6c Th]
kidritalina: checks 
fmorandi: checks 
*** TURN *** [Jh 6c Th] [7s]
kidritalina: bets 280
fmorandi: calls 280
*** RIVER *** [Jh 6c Th 7s] [Td]
kidritalina: bets 560
fmorandi: calls 560
*** SHOW DOWN ***
kidritalina: shows [Qs 7h] (two pair, Tens and Sevens)
fmorandi: shows [Ks 7d] (two pair, Tens and Sevens - King kicker)
fmorandi collected 2240 from pot
*** SUMMARY ***
Total pot 2240 | Rake 0 
Board [Jh 6c Th 7s Td]
Seat 2: vectra79 folded before Flop (didn't bet)
Seat 3: fmorandi showed [Ks 7d] and won (2240) with two pair, Tens and Sevens
Seat 4: ErikLarios2836 (button) folded before Flop (didn't bet)
Seat 5: Caio Mugarte (small blind) folded before Flop
Seat 6: kidritalina (big blind) showed [Qs 7h] and lost with two pair, Tens and Sevens
Seat 7: rebeLoNrun folded before Flop (didn't bet)
Seat 8: lucasveiga20 folded before Flop (didn't bet)
Seat 9: TheMagixFlop folded before Flop (didn't bet)



PokerStars Hand #245447514738: Tournament #3632677041, $0.23+$0.02 USD Hold'em No Limit - Level VI (80/160) - 2023/08/17 18:26:26 AT [2023/08/17 17:26:26 ET]
Table '3632677041 4' 9-max Seat #5 is the button
Seat 2: vectra79 (1816 in chips) 
Seat 3: fmorandi (8415 in chips) 
Seat 4: ErikLarios2836 (1317 in chips) 
Seat 5: Caio Mugarte (1814 in chips) 
Seat 6: kidritalina (8453 in chips) 
Seat 7: rebeLoNrun (2368 in chips) 
Seat 8: lucasveiga20 (5642 in chips) 
Seat 9: TheMagixFlop (2203 in chips) 
vectra79: posts the ante 20
fmorandi: posts the ante 20
ErikLarios2836: posts the ante 20
Caio Mugarte: posts the ante 20
kidritalina: posts the ante 20
rebeLoNrun: posts the ante 20
lucasveiga20: posts the ante 20
TheMagixFlop: posts the ante 20
kidritalina: posts small blind 80
rebeLoNrun: posts big blind 160
*** HOLE CARDS ***
Dealt to Caio Mugarte [Kc As]
lucasveiga20: folds 
TheMagixFlop: folds 
vectra79: folds 
fmorandi: raises 160 to 320
ErikLarios2836: folds 
Caio Mugarte: raises 1474 to 1794 and is all-in
kidritalina: folds 
rebeLoNrun: folds 
fmorandi: calls 1474
*** FLOP *** [8h 3s Jd]
*** TURN *** [8h 3s Jd] [Ah]
*** RIVER *** [8h 3s Jd Ah] [Th]
*** SHOW DOWN ***
fmorandi: shows [9d 9h] (a pair of Nines)
Caio Mugarte: shows [Kc As] (a pair of Aces)
Caio Mugarte collected 3988 from pot
*** SUMMARY ***
Total pot 3988 | Rake 0 
Board [8h 3s Jd Ah Th]
Seat 2: vectra79 folded before Flop (didn't bet)
Seat 3: fmorandi showed [9d 9h] and lost with a pair of Nines
Seat 4: ErikLarios2836 folded before Flop (didn't bet)
Seat 5: Caio Mugarte (button) showed [Kc As] and won (3988) with a pair of Aces
Seat 6: kidritalina (small blind) folded before Flop
Seat 7: rebeLoNrun (big blind) folded before Flop
Seat 8: lucasveiga20 folded before Flop (didn't bet)
Seat 9: TheMagixFlop folded before Flop (didn't bet)



PokerStars Hand #245447528590: Tournament #3632677041, $0.23+$0.02 USD Hold'em No Limit - Level VI (80/160) - 2023/08/17 18:27:08 AT [2023/08/17 17:27:08 ET]
Table '3632677041 4' 9-max Seat #6 is the button
Seat 2: vectra79 (1796 in chips) 
Seat 3: fmorandi (6601 in chips) 
Seat 4: ErikLarios2836 (1297 in chips) 
Seat 5: Caio Mugarte (3988 in chips) 
Seat 6: kidritalina (8353 in chips) 
Seat 7: rebeLoNrun (2188 in chips) 
Seat 8: lucasveiga20 (5622 in chips) 
Seat 9: TheMagixFlop (2183 in chips) 
vectra79: posts the ante 20
fmorandi: posts the ante 20
ErikLarios2836: posts the ante 20
Caio Mugarte: posts the ante 20
kidritalina: posts the ante 20
rebeLoNrun: posts the ante 20
lucasveiga20: posts the ante 20
TheMagixFlop: posts the ante 20
rebeLoNrun: posts small blind 80
lucasveiga20: posts big blind 160
*** HOLE CARDS ***
Dealt to Caio Mugarte [Tc 3h]
TheMagixFlop: folds 
vectra79: folds 
fmorandi: calls 160
ErikLarios2836: folds 
Caio Mugarte: folds 
kidritalina: raises 160 to 320
rebeLoNrun: folds 
lucasveiga20: folds 
fmorandi: calls 160
*** FLOP *** [8c 6h 7h]
fmorandi: checks 
kidritalina: bets 8013 and is all-in
fmorandi: folds 
Uncalled bet (8013) returned to kidritalina
kidritalina collected 1040 from pot
kidritalina: doesn't show hand 
*** SUMMARY ***
Total pot 1040 | Rake 0 
Board [8c 6h 7h]
Seat 2: vectra79 folded before Flop (didn't bet)
Seat 3: fmorandi folded on the Flop
Seat 4: ErikLarios2836 folded before Flop (didn't bet)
Seat 5: Caio Mugarte folded before Flop (didn't bet)
Seat 6: kidritalina (button) collected (1040)
Seat 7: rebeLoNrun (small blind) folded before Flop
Seat 8: lucasveiga20 (big blind) folded before Flop
Seat 9: TheMagixFlop folded before Flop (didn't bet)



PokerStars Hand #245447539064: Tournament #3632677041, $0.23+$0.02 USD Hold'em No Limit - Level VI (80/160) - 2023/08/17 18:27:40 AT [2023/08/17 17:27:40 ET]
Table '3632677041 4' 9-max Seat #7 is the button
Seat 2: vectra79 (1776 in chips) 
Seat 3: fmorandi (6261 in chips) 
Seat 4: ErikLarios2836 (1277 in chips) 
Seat 5: Caio Mugarte (3968 in chips) 
Seat 6: kidritalina (9053 in chips) 
Seat 7: rebeLoNrun (2088 in chips) 
Seat 8: lucasveiga20 (5442 in chips) 
Seat 9: TheMagixFlop (2163 in chips) 
vectra79: posts the ante 20
fmorandi: posts the ante 20
ErikLarios2836: posts the ante 20
Caio Mugarte: posts the ante 20
kidritalina: posts the ante 20
rebeLoNrun: posts the ante 20
lucasveiga20: posts the ante 20
TheMagixFlop: posts the ante 20
lucasveiga20: posts small blind 80
TheMagixFlop: posts big blind 160
*** HOLE CARDS ***
Dealt to Caio Mugarte [Ac 7d]
vectra79: folds 
fmorandi: calls 160
ErikLarios2836: folds 
Caio Mugarte: folds 
kidritalina: folds 
rebeLoNrun: folds 
lucasveiga20: folds 
TheMagixFlop: raises 1983 to 2143 and is all-in
fmorandi: folds 
Uncalled bet (1983) returned to TheMagixFlop
TheMagixFlop collected 560 from pot
*** SUMMARY ***
Total pot 560 | Rake 0 
Seat 2: vectra79 folded before Flop (didn't bet)
Seat 3: fmorandi folded before Flop
Seat 4: ErikLarios2836 folded before Flop (didn't bet)
Seat 5: Caio Mugarte folded before Flop (didn't bet)
Seat 6: kidritalina folded before Flop (didn't bet)
Seat 7: rebeLoNrun (button) folded before Flop (didn't bet)
Seat 8: lucasveiga20 (small blind) folded before Flop
Seat 9: TheMagixFlop (big blind) collected (560)



PokerStars Hand #245447549940: Tournament #3632677041, $0.23+$0.02 USD Hold'em No Limit - Level VI (80/160) - 2023/08/17 18:28:13 AT [2023/08/17 17:28:13 ET]
Table '3632677041 4' 9-max Seat #8 is the button
Seat 2: vectra79 (1756 in chips) 
Seat 3: fmorandi (6081 in chips) 
Seat 4: ErikLarios2836 (1257 in chips) 
Seat 5: Caio Mugarte (3948 in chips) 
Seat 6: kidritalina (9033 in chips) 
Seat 7: rebeLoNrun (2068 in chips) 
Seat 8: lucasveiga20 (5342 in chips) 
Seat 9: TheMagixFlop (2543 in chips) 
vectra79: posts the ante 20
fmorandi: posts the ante 20
ErikLarios2836: posts the ante 20
Caio Mugarte: posts the ante 20
kidritalina: posts the ante 20
rebeLoNrun: posts the ante 20
lucasveiga20: posts the ante 20
TheMagixFlop: posts the ante 20
TheMagixFlop: posts small blind 80
vectra79: posts big blind 160
*** HOLE CARDS ***
Dealt to Caio Mugarte [4d 6s]
fmorandi: folds 
ErikLarios2836: folds 
Caio Mugarte: folds 
kidritalina: folds 
rebeLoNrun: folds 
lucasveiga20: folds 
TheMagixFlop: raises 2363 to 2523 and is all-in
vectra79: folds 
Uncalled bet (2363) returned to TheMagixFlop
TheMagixFlop collected 480 from pot
*** SUMMARY ***
Total pot 480 | Rake 0 
Seat 2: vectra79 (big blind) folded before Flop
Seat 3: fmorandi folded before Flop (didn't bet)
Seat 4: ErikLarios2836 folded before Flop (didn't bet)
Seat 5: Caio Mugarte folded before Flop (didn't bet)
Seat 6: kidritalina folded before Flop (didn't bet)
Seat 7: rebeLoNrun folded before Flop (didn't bet)
Seat 8: lucasveiga20 (button) folded before Flop (didn't bet)
Seat 9: TheMagixFlop (small blind) collected (480)



PokerStars Hand #245447560484: Tournament #3632677041, $0.23+$0.02 USD Hold'em No Limit - Level VI (80/160) - 2023/08/17 18:28:45 AT [2023/08/17 17:28:45 ET]
Table '3632677041 4' 9-max Seat #9 is the button
Seat 2: vectra79 (1576 in chips) 
Seat 3: fmorandi (6061 in chips) 
Seat 4: ErikLarios2836 (1237 in chips) 
Seat 5: Caio Mugarte (3928 in chips) 
Seat 6: kidritalina (9013 in chips) 
Seat 7: rebeLoNrun (2048 in chips) 
Seat 8: lucasveiga20 (5322 in chips) 
Seat 9: TheMagixFlop (2843 in chips) 
vectra79: posts the ante 20
fmorandi: posts the ante 20
ErikLarios2836: posts the ante 20
Caio Mugarte: posts the ante 20
kidritalina: posts the ante 20
rebeLoNrun: posts the ante 20
lucasveiga20: posts the ante 20
TheMagixFlop: posts the ante 20
vectra79: posts small blind 80
fmorandi: posts big blind 160
*** HOLE CARDS ***
Dealt to Caio Mugarte [5c 6s]
ErikLarios2836: folds 
Caio Mugarte: folds 
kidritalina: folds 
rebeLoNrun: folds 
lucasveiga20: folds 
TheMagixFlop: folds 
vectra79: folds 
Uncalled bet (80) returned to fmorandi
fmorandi collected 320 from pot
*** SUMMARY ***
Total pot 320 | Rake 0 
Seat 2: vectra79 (small blind) folded before Flop
Seat 3: fmorandi (big blind) collected (320)
Seat 4: ErikLarios2836 folded before Flop (didn't bet)
Seat 5: Caio Mugarte folded before Flop (didn't bet)
Seat 6: kidritalina folded before Flop (didn't bet)
Seat 7: rebeLoNrun folded before Flop (didn't bet)
Seat 8: lucasveiga20 folded before Flop (didn't bet)
Seat 9: TheMagixFlop (button) folded before Flop (didn't bet)



PokerStars Hand #245447567502: Tournament #3632677041, $0.23+$0.02 USD Hold'em No Limit - Level VI (80/160) - 2023/08/17 18:29:07 AT [2023/08/17 17:29:07 ET]
Table '3632677041 4' 9-max Seat #2 is the button
Seat 2: vectra79 (1476 in chips) 
Seat 3: fmorandi (6281 in chips) 
Seat 4: ErikLarios2836 (1217 in chips) 
Seat 5: Caio Mugarte (3908 in chips) 
Seat 6: kidritalina (8993 in chips) 
Seat 7: rebeLoNrun (2028 in chips) 
Seat 8: lucasveiga20 (5302 in chips) 
Seat 9: TheMagixFlop (2823 in chips) 
vectra79: posts the ante 20
fmorandi: posts the ante 20
ErikLarios2836: posts the ante 20
Caio Mugarte: posts the ante 20
kidritalina: posts the ante 20
rebeLoNrun: posts the ante 20
lucasveiga20: posts the ante 20
TheMagixFlop: posts the ante 20
fmorandi: posts small blind 80
ErikLarios2836: posts big blind 160
*** HOLE CARDS ***
Dealt to Caio Mugarte [3h 6s]
Caio Mugarte: folds 
kidritalina: folds 
rebeLoNrun: folds 
lucasveiga20: folds 
TheMagixFlop: folds 
vectra79: folds 
fmorandi: raises 160 to 320
ErikLarios2836: calls 160
*** FLOP *** [Jh 5d 5h]
fmorandi: checks 
ErikLarios2836: bets 877 and is all-in
fmorandi: calls 877
*** TURN *** [Jh 5d 5h] [Ts]
*** RIVER *** [Jh 5d 5h Ts] [4h]
*** SHOW DOWN ***
fmorandi: shows [Ad Ks] (a pair of Fives)
ErikLarios2836: shows [Jc 8h] (two pair, Jacks and Fives)
ErikLarios2836 collected 2554 from pot
*** SUMMARY ***
Total pot 2554 | Rake 0 
Board [Jh 5d 5h Ts 4h]
Seat 2: vectra79 (button) folded before Flop (didn't bet)
Seat 3: fmorandi (small blind) showed [Ad Ks] and lost with a pair of Fives
Seat 4: ErikLarios2836 (big blind) showed [Jc 8h] and won (2554) with two pair, Jacks and Fives
Seat 5: Caio Mugarte folded before Flop (didn't bet)
Seat 6: kidritalina folded before Flop (didn't bet)
Seat 7: rebeLoNrun folded before Flop (didn't bet)
Seat 8: lucasveiga20 folded before Flop (didn't bet)
Seat 9: TheMagixFlop folded before Flop (didn't bet)



PokerStars Hand #245447583859: Tournament #3632677041, $0.23+$0.02 USD Hold'em No Limit - Level VII (100/200) - 2023/08/17 18:29:58 AT [2023/08/17 17:29:58 ET]
Table '3632677041 4' 9-max Seat #3 is the button
Seat 2: vectra79 (1456 in chips) 
Seat 3: fmorandi (5064 in chips) 
Seat 4: ErikLarios2836 (2554 in chips) 
Seat 5: Caio Mugarte (3888 in chips) 
Seat 6: kidritalina (8973 in chips) 
Seat 7: rebeLoNrun (2008 in chips) 
Seat 8: lucasveiga20 (5282 in chips) 
Seat 9: TheMagixFlop (2803 in chips) 
vectra79: posts the ante 25
fmorandi: posts the ante 25
ErikLarios2836: posts the ante 25
Caio Mugarte: posts the ante 25
kidritalina: posts the ante 25
rebeLoNrun: posts the ante 25
lucasveiga20: posts the ante 25
TheMagixFlop: posts the ante 25
ErikLarios2836: posts small blind 100
Caio Mugarte: posts big blind 200
*** HOLE CARDS ***
Dealt to Caio Mugarte [2c 2h]
kidritalina: folds 
rebeLoNrun: folds 
lucasveiga20: raises 200 to 400
TheMagixFlop: folds 
vectra79: folds 
fmorandi: folds 
ErikLarios2836: folds 
Caio Mugarte: calls 200
*** FLOP *** [9s Jd 9c]
Caio Mugarte: checks 
lucasveiga20: bets 352
Caio Mugarte: folds 
Uncalled bet (352) returned to lucasveiga20
lucasveiga20 collected 1100 from pot
lucasveiga20: doesn't show hand 
*** SUMMARY ***
Total pot 1100 | Rake 0 
Board [9s Jd 9c]
Seat 2: vectra79 folded before Flop (didn't bet)
Seat 3: fmorandi (button) folded before Flop (didn't bet)
Seat 4: ErikLarios2836 (small blind) folded before Flop
Seat 5: Caio Mugarte (big blind) folded on the Flop
Seat 6: kidritalina folded before Flop (didn't bet)
Seat 7: rebeLoNrun folded before Flop (didn't bet)
Seat 8: lucasveiga20 collected (1100)
Seat 9: TheMagixFlop folded before Flop (didn't bet)



PokerStars Hand #245447603884: Tournament #3632677041, $0.23+$0.02 USD Hold'em No Limit - Level VII (100/200) - 2023/08/17 18:30:59 AT [2023/08/17 17:30:59 ET]
Table '3632677041 4' 9-max Seat #4 is the button
Seat 2: vectra79 (1431 in chips) 
Seat 3: fmorandi (5039 in chips) 
Seat 4: ErikLarios2836 (2429 in chips) 
Seat 5: Caio Mugarte (3463 in chips) 
Seat 6: kidritalina (8948 in chips) 
Seat 7: rebeLoNrun (1983 in chips) 
Seat 8: lucasveiga20 (5957 in chips) 
Seat 9: TheMagixFlop (2778 in chips) 
vectra79: posts the ante 25
fmorandi: posts the ante 25
ErikLarios2836: posts the ante 25
Caio Mugarte: posts the ante 25
kidritalina: posts the ante 25
rebeLoNrun: posts the ante 25
lucasveiga20: posts the ante 25
TheMagixFlop: posts the ante 25
Caio Mugarte: posts small blind 100
kidritalina: posts big blind 200
*** HOLE CARDS ***
Dealt to Caio Mugarte [9s 5d]
rebeLoNrun: folds 
lucasveiga20: folds 
TheMagixFlop: folds 
vectra79: folds 
fmorandi: folds 
ErikLarios2836: raises 200 to 400
Caio Mugarte: folds 
kidritalina: calls 200
*** FLOP *** [Ad 7s 5h]
kidritalina: checks 
ErikLarios2836: checks 
*** TURN *** [Ad 7s 5h] [Qc]
kidritalina: bets 550
ErikLarios2836: calls 550
*** RIVER *** [Ad 7s 5h Qc] [4s]
kidritalina: checks 
ErikLarios2836: bets 1454 and is all-in
kidritalina: folds 
Uncalled bet (1454) returned to ErikLarios2836
ErikLarios2836 collected 2200 from pot
ErikLarios2836: doesn't show hand 
*** SUMMARY ***
Total pot 2200 | Rake 0 
Board [Ad 7s 5h Qc 4s]
Seat 2: vectra79 folded before Flop (didn't bet)
Seat 3: fmorandi folded before Flop (didn't bet)
Seat 4: ErikLarios2836 (button) collected (2200)
Seat 5: Caio Mugarte (small blind) folded before Flop
Seat 6: kidritalina (big blind) folded on the River
Seat 7: rebeLoNrun folded before Flop (didn't bet)
Seat 8: lucasveiga20 folded before Flop (didn't bet)
Seat 9: TheMagixFlop folded before Flop (didn't bet)



PokerStars Hand #245447623453: Tournament #3632677041, $0.23+$0.02 USD Hold'em No Limit - Level VII (100/200) - 2023/08/17 18:31:59 AT [2023/08/17 17:31:59 ET]
Table '3632677041 4' 9-max Seat #5 is the button
Seat 2: vectra79 (1406 in chips) 
Seat 3: fmorandi (5014 in chips) 
Seat 4: ErikLarios2836 (3654 in chips) 
Seat 5: Caio Mugarte (3338 in chips) 
Seat 6: kidritalina (7973 in chips) 
Seat 7: rebeLoNrun (1958 in chips) 
Seat 8: lucasveiga20 (5932 in chips) 
Seat 9: TheMagixFlop (2753 in chips) 
vectra79: posts the ante 25
fmorandi: posts the ante 25
ErikLarios2836: posts the ante 25
Caio Mugarte: posts the ante 25
kidritalina: posts the ante 25
rebeLoNrun: posts the ante 25
lucasveiga20: posts the ante 25
TheMagixFlop: posts the ante 25
kidritalina: posts small blind 100
rebeLoNrun: posts big blind 200
*** HOLE CARDS ***
Dealt to Caio Mugarte [Js As]
lucasveiga20: folds 
TheMagixFlop: folds 
vectra79: folds 
fmorandi: folds 
ErikLarios2836: folds 
Caio Mugarte: raises 3113 to 3313 and is all-in
kidritalina: folds 
rebeLoNrun: folds 
Uncalled bet (3113) returned to Caio Mugarte
Caio Mugarte collected 700 from pot
Caio Mugarte: doesn't show hand 
*** SUMMARY ***
Total pot 700 | Rake 0 
Seat 2: vectra79 folded before Flop (didn't bet)
Seat 3: fmorandi folded before Flop (didn't bet)
Seat 4: ErikLarios2836 folded before Flop (didn't bet)
Seat 5: Caio Mugarte (button) collected (700)
Seat 6: kidritalina (small blind) folded before Flop
Seat 7: rebeLoNrun (big blind) folded before Flop
Seat 8: lucasveiga20 folded before Flop (didn't bet)
Seat 9: TheMagixFlop folded before Flop (didn't bet)



PokerStars Hand #245447629618: Tournament #3632677041, $0.23+$0.02 USD Hold'em No Limit - Level VII (100/200) - 2023/08/17 18:32:18 AT [2023/08/17 17:32:18 ET]
Table '3632677041 4' 9-max Seat #6 is the button
Seat 2: vectra79 (1381 in chips) 
Seat 3: fmorandi (4989 in chips) 
Seat 4: ErikLarios2836 (3629 in chips) 
Seat 5: Caio Mugarte (3813 in chips) 
Seat 6: kidritalina (7848 in chips) 
Seat 7: rebeLoNrun (1733 in chips) 
Seat 8: lucasveiga20 (5907 in chips) 
Seat 9: TheMagixFlop (2728 in chips) 
vectra79: posts the ante 25
fmorandi: posts the ante 25
ErikLarios2836: posts the ante 25
Caio Mugarte: posts the ante 25
kidritalina: posts the ante 25
rebeLoNrun: posts the ante 25
lucasveiga20: posts the ante 25
TheMagixFlop: posts the ante 25
rebeLoNrun: posts small blind 100
lucasveiga20: posts big blind 200
*** HOLE CARDS ***
Dealt to Caio Mugarte [4s 6d]
TheMagixFlop: folds 
vectra79: folds 
fmorandi: folds 
ErikLarios2836: folds 
Caio Mugarte: folds 
kidritalina: folds 
rebeLoNrun: raises 1508 to 1708 and is all-in
lucasveiga20: calls 1508
*** FLOP *** [Th Qs 3h]
*** TURN *** [Th Qs 3h] [Kh]
*** RIVER *** [Th Qs 3h Kh] [Qc]
*** SHOW DOWN ***
rebeLoNrun: shows [Jd Qd] (three of a kind, Queens)
lucasveiga20: shows [6s Ah] (a pair of Queens)
rebeLoNrun collected 3616 from pot
*** SUMMARY ***
Total pot 3616 | Rake 0 
Board [Th Qs 3h Kh Qc]
Seat 2: vectra79 folded before Flop (didn't bet)
Seat 3: fmorandi folded before Flop (didn't bet)
Seat 4: ErikLarios2836 folded before Flop (didn't bet)
Seat 5: Caio Mugarte folded before Flop (didn't bet)
Seat 6: kidritalina (button) folded before Flop (didn't bet)
Seat 7: rebeLoNrun (small blind) showed [Jd Qd] and won (3616) with three of a kind, Queens
Seat 8: lucasveiga20 (big blind) showed [6s Ah] and lost with a pair of Queens
Seat 9: TheMagixFlop folded before Flop (didn't bet)



PokerStars Hand #245447644412: Tournament #3632677041, $0.23+$0.02 USD Hold'em No Limit - Level VII (100/200) - 2023/08/17 18:33:03 AT [2023/08/17 17:33:03 ET]
Table '3632677041 4' 9-max Seat #7 is the button
Seat 2: vectra79 (1356 in chips) 
Seat 3: fmorandi (4964 in chips) 
Seat 4: ErikLarios2836 (3604 in chips) 
Seat 5: Caio Mugarte (3788 in chips) 
Seat 6: kidritalina (7823 in chips) 
Seat 7: rebeLoNrun (3616 in chips) 
Seat 8: lucasveiga20 (4174 in chips) 
Seat 9: TheMagixFlop (2703 in chips) 
vectra79: posts the ante 25
fmorandi: posts the ante 25
ErikLarios2836: posts the ante 25
Caio Mugarte: posts the ante 25
kidritalina: posts the ante 25
rebeLoNrun: posts the ante 25
lucasveiga20: posts the ante 25
TheMagixFlop: posts the ante 25
lucasveiga20: posts small blind 100
TheMagixFlop: posts big blind 200
*** HOLE CARDS ***
Dealt to Caio Mugarte [Kd 5h]
vectra79: folds 
fmorandi: folds 
ErikLarios2836: folds 
Caio Mugarte: folds 
kidritalina: folds 
rebeLoNrun: folds 
lucasveiga20: raises 3949 to 4149 and is all-in
TheMagixFlop: folds 
Uncalled bet (3949) returned to lucasveiga20
lucasveiga20 collected 600 from pot
lucasveiga20: doesn't show hand 
*** SUMMARY ***
Total pot 600 | Rake 0 
Seat 2: vectra79 folded before Flop (didn't bet)
Seat 3: fmorandi folded before Flop (didn't bet)
Seat 4: ErikLarios2836 folded before Flop (didn't bet)
Seat 5: Caio Mugarte folded before Flop (didn't bet)
Seat 6: kidritalina folded before Flop (didn't bet)
Seat 7: rebeLoNrun (button) folded before Flop (didn't bet)
Seat 8: lucasveiga20 (small blind) collected (600)
Seat 9: TheMagixFlop (big blind) folded before Flop



PokerStars Hand #245447656056: Tournament #3632677041, $0.23+$0.02 USD Hold'em No Limit - Level VII (100/200) - 2023/08/17 18:33:40 AT [2023/08/17 17:33:40 ET]
Table '3632677041 4' 9-max Seat #8 is the button
Seat 2: vectra79 (1331 in chips) 
Seat 3: fmorandi (4939 in chips) 
Seat 4: ErikLarios2836 (3579 in chips) 
Seat 5: Caio Mugarte (3763 in chips) 
Seat 6: kidritalina (7798 in chips) 
Seat 7: rebeLoNrun (3591 in chips) 
Seat 8: lucasveiga20 (4549 in chips) 
Seat 9: TheMagixFlop (2478 in chips) 
vectra79: posts the ante 25
fmorandi: posts the ante 25
ErikLarios2836: posts the ante 25
Caio Mugarte: posts the ante 25
kidritalina: posts the ante 25
rebeLoNrun: posts the ante 25
lucasveiga20: posts the ante 25
TheMagixFlop: posts the ante 25
TheMagixFlop: posts small blind 100
vectra79: posts big blind 200
*** HOLE CARDS ***
Dealt to Caio Mugarte [7d 2s]
fmorandi: folds 
ErikLarios2836: raises 200 to 400
Caio Mugarte: folds 
kidritalina: folds 
rebeLoNrun: folds 
lucasveiga20: raises 4124 to 4524 and is all-in
TheMagixFlop: folds 
vectra79: folds 
ErikLarios2836: calls 3154 and is all-in
Uncalled bet (970) returned to lucasveiga20
*** FLOP *** [Jc 6c 5c]
*** TURN *** [Jc 6c 5c] [9h]
*** RIVER *** [Jc 6c 5c 9h] [Td]
*** SHOW DOWN ***
ErikLarios2836: shows [Js Jd] (three of a kind, Jacks)
lucasveiga20: shows [Kd Ah] (high card Ace)
ErikLarios2836 collected 7608 from pot
*** SUMMARY ***
Total pot 7608 | Rake 0 
Board [Jc 6c 5c 9h Td]
Seat 2: vectra79 (big blind) folded before Flop
Seat 3: fmorandi folded before Flop (didn't bet)
Seat 4: ErikLarios2836 showed [Js Jd] and won (7608) with three of a kind, Jacks
Seat 5: Caio Mugarte folded before Flop (didn't bet)
Seat 6: kidritalina folded before Flop (didn't bet)
Seat 7: rebeLoNrun folded before Flop (didn't bet)
Seat 8: lucasveiga20 (button) showed [Kd Ah] and lost with high card Ace
Seat 9: TheMagixFlop (small blind) folded before Flop



PokerStars Hand #245447668299: Tournament #3632677041, $0.23+$0.02 USD Hold'em No Limit - Level VII (100/200) - 2023/08/17 18:34:17 AT [2023/08/17 17:34:17 ET]
Table '3632677041 4' 9-max Seat #9 is the button
Seat 2: vectra79 (1106 in chips) 
Seat 3: fmorandi (4914 in chips) 
Seat 4: ErikLarios2836 (7608 in chips) 
Seat 5: Caio Mugarte (3738 in chips) 
Seat 6: kidritalina (7773 in chips) 
Seat 7: rebeLoNrun (3566 in chips) 
Seat 8: lucasveiga20 (970 in chips) 
Seat 9: TheMagixFlop (2353 in chips) 
vectra79: posts the ante 25
fmorandi: posts the ante 25
ErikLarios2836: posts the ante 25
Caio Mugarte: posts the ante 25
kidritalina: posts the ante 25
rebeLoNrun: posts the ante 25
lucasveiga20: posts the ante 25
TheMagixFlop: posts the ante 25
vectra79: posts small blind 100
fmorandi: posts big blind 200
*** HOLE CARDS ***
Dealt to Caio Mugarte [9d 9s]
ErikLarios2836: raises 200 to 400
Caio Mugarte: calls 400
kidritalina: folds 
rebeLoNrun: folds 
lucasveiga20: raises 545 to 945 and is all-in
TheMagixFlop: folds 
vectra79: folds 
fmorandi: folds 
ErikLarios2836: folds 
Caio Mugarte: calls 545
*** FLOP *** [8d 8s Qc]
*** TURN *** [8d 8s Qc] [7h]
*** RIVER *** [8d 8s Qc 7h] [Qh]
*** SHOW DOWN ***
Caio Mugarte: shows [9d 9s] (two pair, Queens and Nines)
lucasveiga20: shows [5d 5s] (two pair, Queens and Eights)
Caio Mugarte collected 2790 from pot
lucasveiga20 finished the tournament in 15th place
*** SUMMARY ***
Total pot 2790 | Rake 0 
Board [8d 8s Qc 7h Qh]
Seat 2: vectra79 (small blind) folded before Flop
Seat 3: fmorandi (big blind) folded before Flop
Seat 4: ErikLarios2836 folded before Flop
Seat 5: Caio Mugarte showed [9d 9s] and won (2790) with two pair, Queens and Nines
Seat 6: kidritalina folded before Flop (didn't bet)
Seat 7: rebeLoNrun folded before Flop (didn't bet)
Seat 8: lucasveiga20 showed [5d 5s] and lost with two pair, Queens and Eights
Seat 9: TheMagixFlop (button) folded before Flop (didn't bet)



PokerStars Hand #245447686997: Tournament #3632677041, $0.23+$0.02 USD Hold'em No Limit - Level VII (100/200) - 2023/08/17 18:35:14 AT [2023/08/17 17:35:14 ET]
Table '3632677041 4' 9-max Seat #2 is the button
Seat 2: vectra79 (981 in chips) 
Seat 3: fmorandi (4689 in chips) 
Seat 4: ErikLarios2836 (7183 in chips) 
Seat 5: Caio Mugarte (5558 in chips) 
Seat 6: kidritalina (7748 in chips) 
Seat 7: rebeLoNrun (3541 in chips) 
Seat 9: TheMagixFlop (2328 in chips) 
vectra79: posts the ante 25
fmorandi: posts the ante 25
ErikLarios2836: posts the ante 25
Caio Mugarte: posts the ante 25
kidritalina: posts the ante 25
rebeLoNrun: posts the ante 25
TheMagixFlop: posts the ante 25
fmorandi: posts small blind 100
ErikLarios2836: posts big blind 200
*** HOLE CARDS ***
Dealt to Caio Mugarte [8s Jh]
Caio Mugarte: folds 
kidritalina: calls 200
rebeLoNrun: folds 
TheMagixFlop: calls 200
vectra79: raises 756 to 956 and is all-in
fmorandi: folds 
ErikLarios2836: folds 
kidritalina: raises 6767 to 7723 and is all-in
TheMagixFlop: folds 
Uncalled bet (6767) returned to kidritalina
*** FLOP *** [Qh 8d 6c]
*** TURN *** [Qh 8d 6c] [4d]
*** RIVER *** [Qh 8d 6c 4d] [4c]
*** SHOW DOWN ***
kidritalina: shows [Ac Tc] (a pair of Fours)
vectra79: shows [Ah Kc] (a pair of Fours - Ace+King kicker)
vectra79 collected 2587 from pot
*** SUMMARY ***
Total pot 2587 | Rake 0 
Board [Qh 8d 6c 4d 4c]
Seat 2: vectra79 (button) showed [Ah Kc] and won (2587) with a pair of Fours
Seat 3: fmorandi (small blind) folded before Flop
Seat 4: ErikLarios2836 (big blind) folded before Flop
Seat 5: Caio Mugarte folded before Flop (didn't bet)
Seat 6: kidritalina showed [Ac Tc] and lost with a pair of Fours
Seat 7: rebeLoNrun folded before Flop (didn't bet)
Seat 9: TheMagixFlop folded before Flop



PokerStars Hand #245447698145: Tournament #3632677041, $0.23+$0.02 USD Hold'em No Limit - Level VII (100/200) - 2023/08/17 18:35:49 AT [2023/08/17 17:35:49 ET]
Table '3632677041 4' 9-max Seat #3 is the button
Seat 2: vectra79 (2587 in chips) 
Seat 3: fmorandi (4564 in chips) 
Seat 4: ErikLarios2836 (6958 in chips) 
Seat 5: Caio Mugarte (5533 in chips) 
Seat 6: kidritalina (6767 in chips) 
Seat 7: rebeLoNrun (3516 in chips) 
Seat 9: TheMagixFlop (2103 in chips) 
vectra79: posts the ante 25
fmorandi: posts the ante 25
ErikLarios2836: posts the ante 25
Caio Mugarte: posts the ante 25
kidritalina: posts the ante 25
rebeLoNrun: posts the ante 25
TheMagixFlop: posts the ante 25
ErikLarios2836: posts small blind 100
Caio Mugarte: posts big blind 200
*** HOLE CARDS ***
Dealt to Caio Mugarte [5h 9h]
kidritalina: folds 
rebeLoNrun: folds 
TheMagixFlop: folds 
vectra79: folds 
fmorandi: folds 
ErikLarios2836: calls 100
Caio Mugarte: checks 
*** FLOP *** [7s Ah As]
ErikLarios2836: bets 260
Caio Mugarte: folds 
Uncalled bet (260) returned to ErikLarios2836
ErikLarios2836 collected 575 from pot
ErikLarios2836: doesn't show hand 
*** SUMMARY ***
Total pot 575 | Rake 0 
Board [7s Ah As]
Seat 2: vectra79 folded before Flop (didn't bet)
Seat 3: fmorandi (button) folded before Flop (didn't bet)
Seat 4: ErikLarios2836 (small blind) collected (575)
Seat 5: Caio Mugarte (big blind) folded on the Flop
Seat 6: kidritalina folded before Flop (didn't bet)
Seat 7: rebeLoNrun folded before Flop (didn't bet)
Seat 9: TheMagixFlop folded before Flop (didn't bet)



PokerStars Hand #245447710213: Tournament #3632677041, $0.23+$0.02 USD Hold'em No Limit - Level VII (100/200) - 2023/08/17 18:36:26 AT [2023/08/17 17:36:26 ET]
Table '3632677041 4' 9-max Seat #4 is the button
Seat 2: vectra79 (2562 in chips) 
Seat 3: fmorandi (4539 in chips) 
Seat 4: ErikLarios2836 (7308 in chips) 
Seat 5: Caio Mugarte (5308 in chips) 
Seat 6: kidritalina (6742 in chips) 
Seat 7: rebeLoNrun (3491 in chips) 
Seat 9: TheMagixFlop (2078 in chips) 
vectra79: posts the ante 25
fmorandi: posts the ante 25
ErikLarios2836: posts the ante 25
Caio Mugarte: posts the ante 25
kidritalina: posts the ante 25
rebeLoNrun: posts the ante 25
TheMagixFlop: posts the ante 25
Caio Mugarte: posts small blind 100
kidritalina: posts big blind 200
*** HOLE CARDS ***
Dealt to Caio Mugarte [9d 7d]
rebeLoNrun: folds 
TheMagixFlop: folds 
vectra79: folds 
fmorandi: folds 
ErikLarios2836: folds 
Caio Mugarte: calls 100
kidritalina: checks 
*** FLOP *** [Ah 7s Ts]
Caio Mugarte: bets 200
kidritalina: folds 
Uncalled bet (200) returned to Caio Mugarte
Caio Mugarte collected 575 from pot
Caio Mugarte: doesn't show hand 
*** SUMMARY ***
Total pot 575 | Rake 0 
Board [Ah 7s Ts]
Seat 2: vectra79 folded before Flop (didn't bet)
Seat 3: fmorandi folded before Flop (didn't bet)
Seat 4: ErikLarios2836 (button) folded before Flop (didn't bet)
Seat 5: Caio Mugarte (small blind) collected (575)
Seat 6: kidritalina (big blind) folded on the Flop
Seat 7: rebeLoNrun folded before Flop (didn't bet)
Seat 9: TheMagixFlop folded before Flop (didn't bet)



PokerStars Hand #245447718195: Tournament #3632677041, $0.23+$0.02 USD Hold'em No Limit - Level VII (100/200) - 2023/08/17 18:36:50 AT [2023/08/17 17:36:50 ET]
Table '3632677041 4' 9-max Seat #5 is the button
Seat 2: vectra79 (2537 in chips) 
Seat 3: fmorandi (4514 in chips) 
Seat 4: ErikLarios2836 (7283 in chips) 
Seat 5: Caio Mugarte (5658 in chips) 
Seat 6: kidritalina (6517 in chips) 
Seat 7: rebeLoNrun (3466 in chips) 
Seat 9: TheMagixFlop (2053 in chips) 
vectra79: posts the ante 25
fmorandi: posts the ante 25
ErikLarios2836: posts the ante 25
Caio Mugarte: posts the ante 25
kidritalina: posts the ante 25
rebeLoNrun: posts the ante 25
TheMagixFlop: posts the ante 25
kidritalina: posts small blind 100
rebeLoNrun: posts big blind 200
*** HOLE CARDS ***
Dealt to Caio Mugarte [Ac Tc]
TheMagixFlop: folds 
vectra79: folds 
fmorandi: folds 
ErikLarios2836: folds 
Caio Mugarte: raises 200 to 400
kidritalina: raises 6092 to 6492 and is all-in
rebeLoNrun: folds 
Caio Mugarte: folds 
Uncalled bet (6092) returned to kidritalina
kidritalina collected 1175 from pot
kidritalina: doesn't show hand 
*** SUMMARY ***
Total pot 1175 | Rake 0 
Seat 2: vectra79 folded before Flop (didn't bet)
Seat 3: fmorandi folded before Flop (didn't bet)
Seat 4: ErikLarios2836 folded before Flop (didn't bet)
Seat 5: Caio Mugarte (button) folded before Flop
Seat 6: kidritalina (small blind) collected (1175)
Seat 7: rebeLoNrun (big blind) folded before Flop
Seat 9: TheMagixFlop folded before Flop (didn't bet)



PokerStars Hand #245447727031: Tournament #3632677041, $0.23+$0.02 USD Hold'em No Limit - Level VII (100/200) - 2023/08/17 18:37:17 AT [2023/08/17 17:37:17 ET]
Table '3632677041 4' 9-max Seat #6 is the button
Seat 2: vectra79 (2512 in chips) 
Seat 3: fmorandi (4489 in chips) 
Seat 4: ErikLarios2836 (7258 in chips) 
Seat 5: Caio Mugarte (5233 in chips) 
Seat 6: kidritalina (7267 in chips) 
Seat 7: rebeLoNrun (3241 in chips) 
Seat 9: TheMagixFlop (2028 in chips) 
vectra79: posts the ante 25
fmorandi: posts the ante 25
ErikLarios2836: posts the ante 25
Caio Mugarte: posts the ante 25
kidritalina: posts the ante 25
rebeLoNrun: posts the ante 25
TheMagixFlop: posts the ante 25
rebeLoNrun: posts small blind 100
TheMagixFlop: posts big blind 200
*** HOLE CARDS ***
Dealt to Caio Mugarte [8d 2h]
vectra79: folds 
fmorandi: calls 200
ErikLarios2836: folds 
Caio Mugarte: folds 
kidritalina: raises 200 to 400
rebeLoNrun: raises 2816 to 3216 and is all-in
TheMagixFlop: folds 
fmorandi: folds 
kidritalina: folds 
Uncalled bet (2816) returned to rebeLoNrun
rebeLoNrun collected 1375 from pot
*** SUMMARY ***
Total pot 1375 | Rake 0 
Seat 2: vectra79 folded before Flop (didn't bet)
Seat 3: fmorandi folded before Flop
Seat 4: ErikLarios2836 folded before Flop (didn't bet)
Seat 5: Caio Mugarte folded before Flop (didn't bet)
Seat 6: kidritalina (button) folded before Flop
Seat 7: rebeLoNrun (small blind) collected (1375)
Seat 9: TheMagixFlop (big blind) folded before Flop



PokerStars Hand #245447737009: Tournament #3632677041, $0.23+$0.02 USD Hold'em No Limit - Level VII (100/200) - 2023/08/17 18:37:48 AT [2023/08/17 17:37:48 ET]
Table '3632677041 4' 9-max Seat #7 is the button
Seat 2: vectra79 (2487 in chips) 
Seat 3: fmorandi (4264 in chips) 
Seat 4: ErikLarios2836 (7233 in chips) 
Seat 5: Caio Mugarte (5208 in chips) 
Seat 6: kidritalina (6842 in chips) 
Seat 7: rebeLoNrun (4191 in chips) 
Seat 9: TheMagixFlop (1803 in chips) 
vectra79: posts the ante 25
fmorandi: posts the ante 25
ErikLarios2836: posts the ante 25
Caio Mugarte: posts the ante 25
kidritalina: posts the ante 25
rebeLoNrun: posts the ante 25
TheMagixFlop: posts the ante 25
TheMagixFlop: posts small blind 100
vectra79: posts big blind 200
*** HOLE CARDS ***
Dealt to Caio Mugarte [6d Qs]
fmorandi: folds 
ErikLarios2836: folds 
Caio Mugarte: folds 
kidritalina: folds 
rebeLoNrun: folds 
TheMagixFlop: raises 1578 to 1778 and is all-in
vectra79: folds 
Uncalled bet (1578) returned to TheMagixFlop
TheMagixFlop collected 575 from pot
*** SUMMARY ***
Total pot 575 | Rake 0 
Seat 2: vectra79 (big blind) folded before Flop
Seat 3: fmorandi folded before Flop (didn't bet)
Seat 4: ErikLarios2836 folded before Flop (didn't bet)
Seat 5: Caio Mugarte folded before Flop (didn't bet)
Seat 6: kidritalina folded before Flop (didn't bet)
Seat 7: rebeLoNrun (button) folded before Flop (didn't bet)
Seat 9: TheMagixFlop (small blind) collected (575)



PokerStars Hand #245447742414: Tournament #3632677041, $0.23+$0.02 USD Hold'em No Limit - Level VII (100/200) - 2023/08/17 18:38:04 AT [2023/08/17 17:38:04 ET]
Table '3632677041 4' 9-max Seat #9 is the button
Seat 2: vectra79 (2262 in chips) 
Seat 3: fmorandi (4239 in chips) 
Seat 4: ErikLarios2836 (7208 in chips) 
Seat 5: Caio Mugarte (5183 in chips) 
Seat 6: kidritalina (6817 in chips) 
Seat 7: rebeLoNrun (4166 in chips) 
Seat 9: TheMagixFlop (2153 in chips) 
vectra79: posts the ante 25
fmorandi: posts the ante 25
ErikLarios2836: posts the ante 25
Caio Mugarte: posts the ante 25
kidritalina: posts the ante 25
rebeLoNrun: posts the ante 25
TheMagixFlop: posts the ante 25
vectra79: posts small blind 100
fmorandi: posts big blind 200
*** HOLE CARDS ***
Dealt to Caio Mugarte [Jd 6d]
ErikLarios2836: folds 
Caio Mugarte: folds 
kidritalina: raises 6592 to 6792 and is all-in
rebeLoNrun: folds 
TheMagixFlop: folds 
vectra79: folds 
fmorandi: folds 
Uncalled bet (6592) returned to kidritalina
kidritalina collected 675 from pot
kidritalina: doesn't show hand 
*** SUMMARY ***
Total pot 675 | Rake 0 
Seat 2: vectra79 (small blind) folded before Flop
Seat 3: fmorandi (big blind) folded before Flop
Seat 4: ErikLarios2836 folded before Flop (didn't bet)
Seat 5: Caio Mugarte folded before Flop (didn't bet)
Seat 6: kidritalina collected (675)
Seat 7: rebeLoNrun folded before Flop (didn't bet)
Seat 9: TheMagixFlop (button) folded before Flop (didn't bet)



PokerStars Hand #245447747699: Tournament #3632677041, $0.23+$0.02 USD Hold'em No Limit - Level VII (100/200) - 2023/08/17 18:38:21 AT [2023/08/17 17:38:21 ET]
Table '3632677041 4' 9-max Seat #2 is the button
Seat 2: vectra79 (2137 in chips) 
Seat 3: fmorandi (4014 in chips) 
Seat 4: ErikLarios2836 (7183 in chips) 
Seat 5: Caio Mugarte (5158 in chips) 
Seat 6: kidritalina (7267 in chips) 
Seat 7: rebeLoNrun (4141 in chips) 
Seat 9: TheMagixFlop (2128 in chips) 
vectra79: posts the ante 25
fmorandi: posts the ante 25
ErikLarios2836: posts the ante 25
Caio Mugarte: posts the ante 25
kidritalina: posts the ante 25
rebeLoNrun: posts the ante 25
TheMagixFlop: posts the ante 25
fmorandi: posts small blind 100
ErikLarios2836: posts big blind 200
*** HOLE CARDS ***
Dealt to Caio Mugarte [Qh 4s]
Caio Mugarte: folds 
kidritalina: folds 
rebeLoNrun: raises 400 to 600
TheMagixFlop: folds 
vectra79: folds 
fmorandi: folds 
ErikLarios2836: folds 
Uncalled bet (400) returned to rebeLoNrun
rebeLoNrun collected 675 from pot
*** SUMMARY ***
Total pot 675 | Rake 0 
Seat 2: vectra79 (button) folded before Flop (didn't bet)
Seat 3: fmorandi (small blind) folded before Flop
Seat 4: ErikLarios2836 (big blind) folded before Flop
Seat 5: Caio Mugarte folded before Flop (didn't bet)
Seat 6: kidritalina folded before Flop (didn't bet)
Seat 7: rebeLoNrun collected (675)
Seat 9: TheMagixFlop folded before Flop (didn't bet)



PokerStars Hand #245447752162: Tournament #3632677041, $0.23+$0.02 USD Hold'em No Limit - Level VII (100/200) - 2023/08/17 18:38:35 AT [2023/08/17 17:38:35 ET]
Table '3632677041 4' 9-max Seat #3 is the button
Seat 2: vectra79 (2112 in chips) 
Seat 3: fmorandi (3889 in chips) 
Seat 4: ErikLarios2836 (6958 in chips) 
Seat 5: Caio Mugarte (5133 in chips) 
Seat 6: kidritalina (7242 in chips) 
Seat 7: rebeLoNrun (4591 in chips) 
Seat 9: TheMagixFlop (2103 in chips) 
vectra79: posts the ante 25
fmorandi: posts the ante 25
ErikLarios2836: posts the ante 25
Caio Mugarte: posts the ante 25
kidritalina: posts the ante 25
rebeLoNrun: posts the ante 25
TheMagixFlop: posts the ante 25
ErikLarios2836: posts small blind 100
Caio Mugarte: posts big blind 200
*** HOLE CARDS ***
Dealt to Caio Mugarte [7s 8s]
kidritalina: folds 
rebeLoNrun: folds 
TheMagixFlop: folds 
vectra79: folds 
fmorandi: folds 
ErikLarios2836: raises 340 to 540
Caio Mugarte: calls 340
*** FLOP *** [Qc 8d 9h]
ErikLarios2836: bets 420
Caio Mugarte: folds 
Uncalled bet (420) returned to ErikLarios2836
ErikLarios2836 collected 1255 from pot
ErikLarios2836: doesn't show hand 
*** SUMMARY ***
Total pot 1255 | Rake 0 
Board [Qc 8d 9h]
Seat 2: vectra79 folded before Flop (didn't bet)
Seat 3: fmorandi (button) folded before Flop (didn't bet)
Seat 4: ErikLarios2836 (small blind) collected (1255)
Seat 5: Caio Mugarte (big blind) folded on the Flop
Seat 6: kidritalina folded before Flop (didn't bet)
Seat 7: rebeLoNrun folded before Flop (didn't bet)
Seat 9: TheMagixFlop folded before Flop (didn't bet)



PokerStars Hand #245447766604: Tournament #3632677041, $0.23+$0.02 USD Hold'em No Limit - Level VII (100/200) - 2023/08/17 18:39:19 AT [2023/08/17 17:39:19 ET]
Table '3632677041 4' 9-max Seat #4 is the button
Seat 2: vectra79 (2087 in chips) 
Seat 3: fmorandi (3864 in chips) 
Seat 4: ErikLarios2836 (7648 in chips) 
Seat 5: Caio Mugarte (4568 in chips) 
Seat 6: kidritalina (7217 in chips) 
Seat 7: rebeLoNrun (4566 in chips) 
Seat 9: TheMagixFlop (2078 in chips) 
vectra79: posts the ante 25
fmorandi: posts the ante 25
ErikLarios2836: posts the ante 25
Caio Mugarte: posts the ante 25
kidritalina: posts the ante 25
rebeLoNrun: posts the ante 25
TheMagixFlop: posts the ante 25
Caio Mugarte: posts small blind 100
kidritalina: posts big blind 200
*** HOLE CARDS ***
Dealt to Caio Mugarte [4c 2d]
rebeLoNrun: folds 
TheMagixFlop: folds 
vectra79: folds 
fmorandi: folds 
ErikLarios2836: folds 
Caio Mugarte: folds 
Uncalled bet (100) returned to kidritalina
kidritalina collected 375 from pot
kidritalina: doesn't show hand 
*** SUMMARY ***
Total pot 375 | Rake 0 
Seat 2: vectra79 folded before Flop (didn't bet)
Seat 3: fmorandi folded before Flop (didn't bet)
Seat 4: ErikLarios2836 (button) folded before Flop (didn't bet)
Seat 5: Caio Mugarte (small blind) folded before Flop
Seat 6: kidritalina (big blind) collected (375)
Seat 7: rebeLoNrun folded before Flop (didn't bet)
Seat 9: TheMagixFlop folded before Flop (didn't bet)



PokerStars Hand #245447776062: Tournament #3632677041, $0.23+$0.02 USD Hold'em No Limit - Level VIII (150/300) - 2023/08/17 18:39:49 AT [2023/08/17 17:39:49 ET]
Table '3632677041 4' 9-max Seat #5 is the button
Seat 2: vectra79 (2062 in chips) 
Seat 3: fmorandi (3839 in chips) 
Seat 4: ErikLarios2836 (7623 in chips) 
Seat 5: Caio Mugarte (4443 in chips) 
Seat 6: kidritalina (7467 in chips) 
Seat 7: rebeLoNrun (4541 in chips) 
Seat 9: TheMagixFlop (2053 in chips) 
vectra79: posts the ante 25
fmorandi: posts the ante 25
ErikLarios2836: posts the ante 25
Caio Mugarte: posts the ante 25
kidritalina: posts the ante 25
rebeLoNrun: posts the ante 25
TheMagixFlop: posts the ante 25
kidritalina: posts small blind 150
rebeLoNrun: posts big blind 300
*** HOLE CARDS ***
Dealt to Caio Mugarte [9s 2c]
TheMagixFlop: raises 1728 to 2028 and is all-in
vectra79: folds 
fmorandi: folds 
ErikLarios2836: raises 5570 to 7598 and is all-in
Caio Mugarte: folds 
kidritalina: folds 
rebeLoNrun: folds 
Uncalled bet (5570) returned to ErikLarios2836
*** FLOP *** [Js 6c 4d]
*** TURN *** [Js 6c 4d] [Ad]
*** RIVER *** [Js 6c 4d Ad] [As]
*** SHOW DOWN ***
TheMagixFlop: shows [8c 8s] (two pair, Aces and Eights)
ErikLarios2836: shows [7h 7c] (two pair, Aces and Sevens)
TheMagixFlop collected 4681 from pot
*** SUMMARY ***
Total pot 4681 | Rake 0 
Board [Js 6c 4d Ad As]
Seat 2: vectra79 folded before Flop (didn't bet)
Seat 3: fmorandi folded before Flop (didn't bet)
Seat 4: ErikLarios2836 showed [7h 7c] and lost with two pair, Aces and Sevens
Seat 5: Caio Mugarte (button) folded before Flop (didn't bet)
Seat 6: kidritalina (small blind) folded before Flop
Seat 7: rebeLoNrun (big blind) folded before Flop
Seat 9: TheMagixFlop showed [8c 8s] and won (4681) with two pair, Aces and Eights



PokerStars Hand #245447786197: Tournament #3632677041, $0.23+$0.02 USD Hold'em No Limit - Level VIII (150/300) - 2023/08/17 18:40:21 AT [2023/08/17 17:40:21 ET]
Table '3632677041 4' 9-max Seat #6 is the button
Seat 2: vectra79 (2037 in chips) 
Seat 3: fmorandi (3814 in chips) 
Seat 4: ErikLarios2836 (5570 in chips) 
Seat 5: Caio Mugarte (4418 in chips) 
Seat 6: kidritalina (7292 in chips) 
Seat 7: rebeLoNrun (4216 in chips) 
Seat 9: TheMagixFlop (4681 in chips) 
vectra79: posts the ante 25
fmorandi: posts the ante 25
ErikLarios2836: posts the ante 25
Caio Mugarte: posts the ante 25
kidritalina: posts the ante 25
rebeLoNrun: posts the ante 25
TheMagixFlop: posts the ante 25
rebeLoNrun: posts small blind 150
TheMagixFlop: posts big blind 300
*** HOLE CARDS ***
Dealt to Caio Mugarte [Ts Jc]
vectra79: folds 
fmorandi: folds 
ErikLarios2836: folds 
Caio Mugarte: folds 
kidritalina: folds 
rebeLoNrun: folds 
Uncalled bet (150) returned to TheMagixFlop
TheMagixFlop collected 475 from pot
*** SUMMARY ***
Total pot 475 | Rake 0 
Seat 2: vectra79 folded before Flop (didn't bet)
Seat 3: fmorandi folded before Flop (didn't bet)
Seat 4: ErikLarios2836 folded before Flop (didn't bet)
Seat 5: Caio Mugarte folded before Flop (didn't bet)
Seat 6: kidritalina (button) folded before Flop (didn't bet)
Seat 7: rebeLoNrun (small blind) folded before Flop
Seat 9: TheMagixFlop (big blind) collected (475)



PokerStars Hand #245447792286: Tournament #3632677041, $0.23+$0.02 USD Hold'em No Limit - Level VIII (150/300) - 2023/08/17 18:40:40 AT [2023/08/17 17:40:40 ET]
Table '3632677041 4' 9-max Seat #7 is the button
Seat 2: vectra79 (2012 in chips) 
Seat 3: fmorandi (3789 in chips) 
Seat 4: ErikLarios2836 (5545 in chips) 
Seat 5: Caio Mugarte (4393 in chips) 
Seat 6: kidritalina (7267 in chips) 
Seat 7: rebeLoNrun (4041 in chips) 
Seat 9: TheMagixFlop (4981 in chips) 
vectra79: posts the ante 25
fmorandi: posts the ante 25
ErikLarios2836: posts the ante 25
Caio Mugarte: posts the ante 25
kidritalina: posts the ante 25
rebeLoNrun: posts the ante 25
TheMagixFlop: posts the ante 25
TheMagixFlop: posts small blind 150
vectra79: posts big blind 300
*** HOLE CARDS ***
Dealt to Caio Mugarte [6h Js]
fmorandi: raises 300 to 600
ErikLarios2836: calls 600
Caio Mugarte: folds 
kidritalina: folds 
rebeLoNrun: folds 
TheMagixFlop: folds 
vectra79: calls 300
*** FLOP *** [2h 4d 6d]
vectra79: checks 
fmorandi: bets 300
ErikLarios2836: calls 300
vectra79: folds 
*** TURN *** [2h 4d 6d] [Qh]
fmorandi: bets 1363
ErikLarios2836: folds 
Uncalled bet (1363) returned to fmorandi
fmorandi collected 2725 from pot
*** SUMMARY ***
Total pot 2725 | Rake 0 
Board [2h 4d 6d Qh]
Seat 2: vectra79 (big blind) folded on the Flop
Seat 3: fmorandi collected (2725)
Seat 4: ErikLarios2836 folded on the Turn
Seat 5: Caio Mugarte folded before Flop (didn't bet)
Seat 6: kidritalina folded before Flop (didn't bet)
Seat 7: rebeLoNrun (button) folded before Flop (didn't bet)
Seat 9: TheMagixFlop (small blind) folded before Flop



PokerStars Hand #245447807825: Tournament #3632677041, $0.23+$0.02 USD Hold'em No Limit - Level VIII (150/300) - 2023/08/17 18:41:29 AT [2023/08/17 17:41:29 ET]
Table '3632677041 4' 9-max Seat #9 is the button
Seat 2: vectra79 (1387 in chips) 
Seat 3: fmorandi (5589 in chips) 
Seat 4: ErikLarios2836 (4620 in chips) 
Seat 5: Caio Mugarte (4368 in chips) 
Seat 6: kidritalina (7242 in chips) 
Seat 7: rebeLoNrun (4016 in chips) 
Seat 9: TheMagixFlop (4806 in chips) 
vectra79: posts the ante 25
fmorandi: posts the ante 25
ErikLarios2836: posts the ante 25
Caio Mugarte: posts the ante 25
kidritalina: posts the ante 25
rebeLoNrun: posts the ante 25
TheMagixFlop: posts the ante 25
vectra79: posts small blind 150
fmorandi: posts big blind 300
*** HOLE CARDS ***
Dealt to Caio Mugarte [7h 8s]
ErikLarios2836: raises 300 to 600
Caio Mugarte: folds 
kidritalina: folds 
rebeLoNrun: raises 3391 to 3991 and is all-in
TheMagixFlop: folds 
vectra79: folds 
fmorandi: folds 
ErikLarios2836: folds 
Uncalled bet (3391) returned to rebeLoNrun
rebeLoNrun collected 1825 from pot
*** SUMMARY ***
Total pot 1825 | Rake 0 
Seat 2: vectra79 (small blind) folded before Flop
Seat 3: fmorandi (big blind) folded before Flop
Seat 4: ErikLarios2836 folded before Flop
Seat 5: Caio Mugarte folded before Flop (didn't bet)
Seat 6: kidritalina folded before Flop (didn't bet)
Seat 7: rebeLoNrun collected (1825)
Seat 9: TheMagixFlop (button) folded before Flop (didn't bet)



PokerStars Hand #245447817135: Tournament #3632677041, $0.23+$0.02 USD Hold'em No Limit - Level VIII (150/300) - 2023/08/17 18:41:58 AT [2023/08/17 17:41:58 ET]
Table '3632677041 4' 9-max Seat #2 is the button
Seat 2: vectra79 (1212 in chips) 
Seat 3: fmorandi (5264 in chips) 
Seat 4: ErikLarios2836 (3995 in chips) 
Seat 5: Caio Mugarte (4343 in chips) 
Seat 6: kidritalina (7217 in chips) 
Seat 7: rebeLoNrun (5216 in chips) 
Seat 9: TheMagixFlop (4781 in chips) 
vectra79: posts the ante 25
fmorandi: posts the ante 25
ErikLarios2836: posts the ante 25
Caio Mugarte: posts the ante 25
kidritalina: posts the ante 25
rebeLoNrun: posts the ante 25
TheMagixFlop: posts the ante 25
fmorandi: posts small blind 150
ErikLarios2836: posts big blind 300
*** HOLE CARDS ***
Dealt to Caio Mugarte [3s 4d]
Caio Mugarte: folds 
kidritalina: folds 
rebeLoNrun: folds 
TheMagixFlop: folds 
vectra79: raises 887 to 1187 and is all-in
fmorandi: folds 
ErikLarios2836: folds 
Uncalled bet (887) returned to vectra79
vectra79 collected 925 from pot
*** SUMMARY ***
Total pot 925 | Rake 0 
Seat 2: vectra79 (button) collected (925)
Seat 3: fmorandi (small blind) folded before Flop
Seat 4: ErikLarios2836 (big blind) folded before Flop
Seat 5: Caio Mugarte folded before Flop (didn't bet)
Seat 6: kidritalina folded before Flop (didn't bet)
Seat 7: rebeLoNrun folded before Flop (didn't bet)
Seat 9: TheMagixFlop folded before Flop (didn't bet)



PokerStars Hand #245447824763: Tournament #3632677041, $0.23+$0.02 USD Hold'em No Limit - Level VIII (150/300) - 2023/08/17 18:42:22 AT [2023/08/17 17:42:22 ET]
Table '3632677041 4' 9-max Seat #3 is the button
Seat 2: vectra79 (1812 in chips) 
Seat 3: fmorandi (5089 in chips) 
Seat 4: ErikLarios2836 (3670 in chips) 
Seat 5: Caio Mugarte (4318 in chips) 
Seat 6: kidritalina (7192 in chips) 
Seat 7: rebeLoNrun (5191 in chips) 
Seat 9: TheMagixFlop (4756 in chips) 
vectra79: posts the ante 25
fmorandi: posts the ante 25
ErikLarios2836: posts the ante 25
Caio Mugarte: posts the ante 25
kidritalina: posts the ante 25
rebeLoNrun: posts the ante 25
TheMagixFlop: posts the ante 25
ErikLarios2836: posts small blind 150
Caio Mugarte: posts big blind 300
*** HOLE CARDS ***
Dealt to Caio Mugarte [2c Qh]
kidritalina: folds 
rebeLoNrun: folds 
TheMagixFlop: folds 
vectra79: folds 
fmorandi: folds 
ErikLarios2836: calls 150
Caio Mugarte: checks 
*** FLOP *** [7h 8d 2s]
ErikLarios2836: checks 
Caio Mugarte: checks 
*** TURN *** [7h 8d 2s] [Kh]
ErikLarios2836: checks 
Caio Mugarte: bets 300
ErikLarios2836: folds 
Uncalled bet (300) returned to Caio Mugarte
Caio Mugarte collected 775 from pot
Caio Mugarte: doesn't show hand 
*** SUMMARY ***
Total pot 775 | Rake 0 
Board [7h 8d 2s Kh]
Seat 2: vectra79 folded before Flop (didn't bet)
Seat 3: fmorandi (button) folded before Flop (didn't bet)
Seat 4: ErikLarios2836 (small blind) folded on the Turn
Seat 5: Caio Mugarte (big blind) collected (775)
Seat 6: kidritalina folded before Flop (didn't bet)
Seat 7: rebeLoNrun folded before Flop (didn't bet)
Seat 9: TheMagixFlop folded before Flop (didn't bet)



PokerStars Hand #245447847064: Tournament #3632677041, $0.23+$0.02 USD Hold'em No Limit - Level VIII (150/300) - 2023/08/17 18:43:31 AT [2023/08/17 17:43:31 ET]
Table '3632677041 4' 9-max Seat #4 is the button
Seat 2: vectra79 (1787 in chips) 
Seat 4: ErikLarios2836 (3345 in chips) 
Seat 5: Caio Mugarte (4768 in chips) 
Seat 6: kidritalina (7167 in chips) 
Seat 7: rebeLoNrun (5166 in chips) 
Seat 9: TheMagixFlop (4731 in chips) 
vectra79: posts the ante 25
ErikLarios2836: posts the ante 25
Caio Mugarte: posts the ante 25
kidritalina: posts the ante 25
rebeLoNrun: posts the ante 25
TheMagixFlop: posts the ante 25
Caio Mugarte: posts small blind 150
kidritalina: posts big blind 300
*** HOLE CARDS ***
Dealt to Caio Mugarte [3s 6h]
rebeLoNrun has timed out
rebeLoNrun: folds 
rebeLoNrun is sitting out
TheMagixFlop: folds 
vectra79: folds 
rebeLoNrun has returned
ErikLarios2836: folds 
Caio Mugarte: folds 
Uncalled bet (150) returned to kidritalina
kidritalina collected 450 from pot
kidritalina: doesn't show hand 
*** SUMMARY ***
Total pot 450 | Rake 0 
Seat 2: vectra79 folded before Flop (didn't bet)
Seat 4: ErikLarios2836 (button) folded before Flop (didn't bet)
Seat 5: Caio Mugarte (small blind) folded before Flop
Seat 6: kidritalina (big blind) collected (450)
Seat 7: rebeLoNrun folded before Flop (didn't bet)
Seat 9: TheMagixFlop folded before Flop (didn't bet)



PokerStars Hand #245447854882: Tournament #3632677041, $0.23+$0.02 USD Hold'em No Limit - Level VIII (150/300) - 2023/08/17 18:43:55 AT [2023/08/17 17:43:55 ET]
Table '3632677041 4' 9-max Seat #5 is the button
Seat 2: vectra79 (1762 in chips) 
Seat 4: ErikLarios2836 (3320 in chips) 
Seat 5: Caio Mugarte (4593 in chips) 
Seat 6: kidritalina (7442 in chips) 
Seat 7: rebeLoNrun (5141 in chips) 
Seat 9: TheMagixFlop (4706 in chips) 
vectra79: posts the ante 25
ErikLarios2836: posts the ante 25
Caio Mugarte: posts the ante 25
kidritalina: posts the ante 25
rebeLoNrun: posts the ante 25
TheMagixFlop: posts the ante 25
kidritalina: posts small blind 150
rebeLoNrun: posts big blind 300
*** HOLE CARDS ***
Dealt to Caio Mugarte [7d 3s]
TheMagixFlop: folds 
vectra79: folds 
ErikLarios2836: folds 
Caio Mugarte: folds 
kidritalina: folds 
Uncalled bet (150) returned to rebeLoNrun
rebeLoNrun collected 450 from pot
*** SUMMARY ***
Total pot 450 | Rake 0 
Seat 2: vectra79 folded before Flop (didn't bet)
Seat 4: ErikLarios2836 folded before Flop (didn't bet)
Seat 5: Caio Mugarte (button) folded before Flop (didn't bet)
Seat 6: kidritalina (small blind) folded before Flop
Seat 7: rebeLoNrun (big blind) collected (450)
Seat 9: TheMagixFlop folded before Flop (didn't bet)



PokerStars Hand #245447860939: Tournament #3632677041, $0.23+$0.02 USD Hold'em No Limit - Level VIII (150/300) - 2023/08/17 18:44:14 AT [2023/08/17 17:44:14 ET]
Table '3632677041 4' 9-max Seat #6 is the button
Seat 2: vectra79 (1737 in chips) 
Seat 4: ErikLarios2836 (3295 in chips) 
Seat 5: Caio Mugarte (4568 in chips) 
Seat 6: kidritalina (7267 in chips) 
Seat 7: rebeLoNrun (5416 in chips) 
Seat 9: TheMagixFlop (4681 in chips) 
vectra79: posts the ante 25
ErikLarios2836: posts the ante 25
Caio Mugarte: posts the ante 25
kidritalina: posts the ante 25
rebeLoNrun: posts the ante 25
TheMagixFlop: posts the ante 25
rebeLoNrun: posts small blind 150
TheMagixFlop: posts big blind 300
*** HOLE CARDS ***
Dealt to Caio Mugarte [Qc 8h]
vectra79: folds 
ErikLarios2836: folds 
Caio Mugarte: folds 
kidritalina: folds 
rebeLoNrun: folds 
Uncalled bet (150) returned to TheMagixFlop
TheMagixFlop collected 450 from pot
*** SUMMARY ***
Total pot 450 | Rake 0 
Seat 2: vectra79 folded before Flop (didn't bet)
Seat 4: ErikLarios2836 folded before Flop (didn't bet)
Seat 5: Caio Mugarte folded before Flop (didn't bet)
Seat 6: kidritalina (button) folded before Flop (didn't bet)
Seat 7: rebeLoNrun (small blind) folded before Flop
Seat 9: TheMagixFlop (big blind) collected (450)



PokerStars Hand #245447868900: Tournament #3632677041, $0.23+$0.02 USD Hold'em No Limit - Level VIII (150/300) - 2023/08/17 18:44:39 AT [2023/08/17 17:44:39 ET]
Table '3632677041 4' 9-max Seat #7 is the button
Seat 2: vectra79 (1712 in chips) 
Seat 4: ErikLarios2836 (3270 in chips) 
Seat 5: Caio Mugarte (4543 in chips) 
Seat 6: kidritalina (7242 in chips) 
Seat 7: rebeLoNrun (5241 in chips) 
Seat 9: TheMagixFlop (4956 in chips) 
vectra79: posts the ante 25
ErikLarios2836: posts the ante 25
Caio Mugarte: posts the ante 25
kidritalina: posts the ante 25
rebeLoNrun: posts the ante 25
TheMagixFlop: posts the ante 25
TheMagixFlop: posts small blind 150
vectra79: posts big blind 300
*** HOLE CARDS ***
Dealt to Caio Mugarte [Qc Qh]
ErikLarios2836: folds 
Caio Mugarte: raises 300 to 600
kidritalina: folds 
rebeLoNrun: folds 
TheMagixFlop: folds 
vectra79: folds 
Uncalled bet (300) returned to Caio Mugarte
Caio Mugarte collected 900 from pot
Caio Mugarte: doesn't show hand 
*** SUMMARY ***
Total pot 900 | Rake 0 
Seat 2: vectra79 (big blind) folded before Flop
Seat 4: ErikLarios2836 folded before Flop (didn't bet)
Seat 5: Caio Mugarte collected (900)
Seat 6: kidritalina folded before Flop (didn't bet)
Seat 7: rebeLoNrun (button) folded before Flop (didn't bet)
Seat 9: TheMagixFlop (small blind) folded before Flop



PokerStars Hand #245447874916: Tournament #3632677041, $0.23+$0.02 USD Hold'em No Limit - Level VIII (150/300) - 2023/08/17 18:44:58 AT [2023/08/17 17:44:58 ET]
Table '3632677041 4' 9-max Seat #9 is the button
Seat 2: vectra79 (1387 in chips) 
Seat 4: ErikLarios2836 (3245 in chips) 
Seat 5: Caio Mugarte (5118 in chips) 
Seat 6: kidritalina (7217 in chips) 
Seat 7: rebeLoNrun (5216 in chips) 
Seat 9: TheMagixFlop (4781 in chips) 
vectra79: posts the ante 25
ErikLarios2836: posts the ante 25
Caio Mugarte: posts the ante 25
kidritalina: posts the ante 25
rebeLoNrun: posts the ante 25
TheMagixFlop: posts the ante 25
vectra79: posts small blind 150
ErikLarios2836: posts big blind 300
*** HOLE CARDS ***
Dealt to Caio Mugarte [5h Kh]
Caio Mugarte: folds 
kidritalina: raises 600 to 900
rebeLoNrun: folds 
TheMagixFlop: folds 
vectra79: folds 
ErikLarios2836: folds 
Uncalled bet (600) returned to kidritalina
kidritalina collected 900 from pot
kidritalina: doesn't show hand 
*** SUMMARY ***
Total pot 900 | Rake 0 
Seat 2: vectra79 (small blind) folded before Flop
Seat 4: ErikLarios2836 (big blind) folded before Flop
Seat 5: Caio Mugarte folded before Flop (didn't bet)
Seat 6: kidritalina collected (900)
Seat 7: rebeLoNrun folded before Flop (didn't bet)
Seat 9: TheMagixFlop (button) folded before Flop (didn't bet)



PokerStars Hand #245447880108: Tournament #3632677041, $0.23+$0.02 USD Hold'em No Limit - Level VIII (150/300) - 2023/08/17 18:45:14 AT [2023/08/17 17:45:14 ET]
Table '3632677041 4' 9-max Seat #2 is the button
Seat 2: vectra79 (1212 in chips) 
Seat 4: ErikLarios2836 (2920 in chips) 
Seat 5: Caio Mugarte (5093 in chips) 
Seat 6: kidritalina (7792 in chips) 
Seat 7: rebeLoNrun (5191 in chips) 
Seat 9: TheMagixFlop (4756 in chips) 
vectra79: posts the ante 25
ErikLarios2836: posts the ante 25
Caio Mugarte: posts the ante 25
kidritalina: posts the ante 25
rebeLoNrun: posts the ante 25
TheMagixFlop: posts the ante 25
ErikLarios2836: posts small blind 150
Caio Mugarte: posts big blind 300
*** HOLE CARDS ***
Dealt to Caio Mugarte [9d 7h]
kidritalina: folds 
rebeLoNrun: folds 
TheMagixFlop: folds 
vectra79: folds 
ErikLarios2836: raises 2595 to 2895 and is all-in
Caio Mugarte: folds 
Uncalled bet (2595) returned to ErikLarios2836
ErikLarios2836 collected 750 from pot
ErikLarios2836: doesn't show hand 
*** SUMMARY ***
Total pot 750 | Rake 0 
Seat 2: vectra79 (button) folded before Flop (didn't bet)
Seat 4: ErikLarios2836 (small blind) collected (750)
Seat 5: Caio Mugarte (big blind) folded before Flop
Seat 6: kidritalina folded before Flop (didn't bet)
Seat 7: rebeLoNrun folded before Flop (didn't bet)
Seat 9: TheMagixFlop folded before Flop (didn't bet)



PokerStars Hand #245447886152: Tournament #3632677041, $0.23+$0.02 USD Hold'em No Limit - Level VIII (150/300) - 2023/08/17 18:45:33 AT [2023/08/17 17:45:33 ET]
Table '3632677041 4' 9-max Seat #4 is the button
Seat 2: vectra79 (1187 in chips) 
Seat 4: ErikLarios2836 (3345 in chips) 
Seat 5: Caio Mugarte (4768 in chips) 
Seat 6: kidritalina (7767 in chips) 
Seat 7: rebeLoNrun (5166 in chips) 
Seat 9: TheMagixFlop (4731 in chips) 
vectra79: posts the ante 25
ErikLarios2836: posts the ante 25
Caio Mugarte: posts the ante 25
kidritalina: posts the ante 25
rebeLoNrun: posts the ante 25
TheMagixFlop: posts the ante 25
Caio Mugarte: posts small blind 150
kidritalina: posts big blind 300
*** HOLE CARDS ***
Dealt to Caio Mugarte [Ad 8c]
rebeLoNrun: folds 
TheMagixFlop: folds 
vectra79: folds 
ErikLarios2836: folds 
Caio Mugarte: calls 150
kidritalina: checks 
*** FLOP *** [Qh Kh 3h]
Caio Mugarte: checks 
kidritalina: checks 
*** TURN *** [Qh Kh 3h] [7h]
Caio Mugarte: checks 
kidritalina: bets 375
Caio Mugarte: folds 
Uncalled bet (375) returned to kidritalina
kidritalina collected 750 from pot
kidritalina: doesn't show hand 
*** SUMMARY ***
Total pot 750 | Rake 0 
Board [Qh Kh 3h 7h]
Seat 2: vectra79 folded before Flop (didn't bet)
Seat 4: ErikLarios2836 (button) folded before Flop (didn't bet)
Seat 5: Caio Mugarte (small blind) folded on the Turn
Seat 6: kidritalina (big blind) collected (750)
Seat 7: rebeLoNrun folded before Flop (didn't bet)
Seat 9: TheMagixFlop folded before Flop (didn't bet)



PokerStars Hand #245447895373: Tournament #3632677041, $0.23+$0.02 USD Hold'em No Limit - Level VIII (150/300) - 2023/08/17 18:46:02 AT [2023/08/17 17:46:02 ET]
Table '3632677041 4' 9-max Seat #5 is the button
Seat 2: vectra79 (1162 in chips) 
Seat 4: ErikLarios2836 (3320 in chips) 
Seat 5: Caio Mugarte (4443 in chips) 
Seat 6: kidritalina (8192 in chips) 
Seat 7: rebeLoNrun (5141 in chips) 
Seat 9: TheMagixFlop (4706 in chips) 
vectra79: posts the ante 25
ErikLarios2836: posts the ante 25
Caio Mugarte: posts the ante 25
kidritalina: posts the ante 25
rebeLoNrun: posts the ante 25
TheMagixFlop: posts the ante 25
kidritalina: posts small blind 150
rebeLoNrun: posts big blind 300
*** HOLE CARDS ***
Dealt to Caio Mugarte [Kh 5h]
TheMagixFlop: folds 
vectra79: folds 
ErikLarios2836: folds 
Caio Mugarte: folds 
kidritalina: folds 
Uncalled bet (150) returned to rebeLoNrun
rebeLoNrun collected 450 from pot
*** SUMMARY ***
Total pot 450 | Rake 0 
Seat 2: vectra79 folded before Flop (didn't bet)
Seat 4: ErikLarios2836 folded before Flop (didn't bet)
Seat 5: Caio Mugarte (button) folded before Flop (didn't bet)
Seat 6: kidritalina (small blind) folded before Flop
Seat 7: rebeLoNrun (big blind) collected (450)
Seat 9: TheMagixFlop folded before Flop (didn't bet)



PokerStars Hand #245447900848: Tournament #3632677041, $0.23+$0.02 USD Hold'em No Limit - Level VIII (150/300) - 2023/08/17 18:46:19 AT [2023/08/17 17:46:19 ET]
Table '3632677041 4' 9-max Seat #6 is the button
Seat 2: vectra79 (1137 in chips) 
Seat 4: ErikLarios2836 (3295 in chips) 
Seat 5: Caio Mugarte (4418 in chips) 
Seat 6: kidritalina (8017 in chips) 
Seat 7: rebeLoNrun (5416 in chips) 
Seat 9: TheMagixFlop (4681 in chips) 
vectra79: posts the ante 25
ErikLarios2836: posts the ante 25
Caio Mugarte: posts the ante 25
kidritalina: posts the ante 25
rebeLoNrun: posts the ante 25
TheMagixFlop: posts the ante 25
rebeLoNrun: posts small blind 150
TheMagixFlop: posts big blind 300
*** HOLE CARDS ***
Dealt to Caio Mugarte [7s 4h]
vectra79: folds 
ErikLarios2836: folds 
Caio Mugarte: folds 
kidritalina: raises 300 to 600
rebeLoNrun: folds 
TheMagixFlop: folds 
Uncalled bet (300) returned to kidritalina
kidritalina collected 900 from pot
kidritalina: doesn't show hand 
*** SUMMARY ***
Total pot 900 | Rake 0 
Seat 2: vectra79 folded before Flop (didn't bet)
Seat 4: ErikLarios2836 folded before Flop (didn't bet)
Seat 5: Caio Mugarte folded before Flop (didn't bet)
Seat 6: kidritalina (button) collected (900)
Seat 7: rebeLoNrun (small blind) folded before Flop
Seat 9: TheMagixFlop (big blind) folded before Flop



PokerStars Hand #245447909560: Tournament #3632677041, $0.23+$0.02 USD Hold'em No Limit - Level VIII (150/300) - 2023/08/17 18:46:46 AT [2023/08/17 17:46:46 ET]
Table '3632677041 4' 9-max Seat #7 is the button
Seat 2: vectra79 (1112 in chips) 
Seat 4: ErikLarios2836 (3270 in chips) 
Seat 5: Caio Mugarte (4393 in chips) 
Seat 6: kidritalina (8592 in chips) 
Seat 7: rebeLoNrun (5241 in chips) 
Seat 9: TheMagixFlop (4356 in chips) 
vectra79: posts the ante 25
ErikLarios2836: posts the ante 25
Caio Mugarte: posts the ante 25
kidritalina: posts the ante 25
rebeLoNrun: posts the ante 25
TheMagixFlop: posts the ante 25
TheMagixFlop: posts small blind 150
vectra79: posts big blind 300
*** HOLE CARDS ***
Dealt to Caio Mugarte [9d 2s]
ErikLarios2836: folds 
Caio Mugarte: folds 
kidritalina: folds 
rebeLoNrun: folds 
TheMagixFlop: folds 
Uncalled bet (150) returned to vectra79
vectra79 collected 450 from pot
*** SUMMARY ***
Total pot 450 | Rake 0 
Seat 2: vectra79 (big blind) collected (450)
Seat 4: ErikLarios2836 folded before Flop (didn't bet)
Seat 5: Caio Mugarte folded before Flop (didn't bet)
Seat 6: kidritalina folded before Flop (didn't bet)
Seat 7: rebeLoNrun (button) folded before Flop (didn't bet)
Seat 9: TheMagixFlop (small blind) folded before Flop



PokerStars Hand #245447915266: Tournament #3632677041, $0.23+$0.02 USD Hold'em No Limit - Level VIII (150/300) - 2023/08/17 18:47:05 AT [2023/08/17 17:47:05 ET]
Table '3632677041 4' 9-max Seat #9 is the button
Seat 2: vectra79 (1387 in chips) 
Seat 4: ErikLarios2836 (3245 in chips) 
Seat 5: Caio Mugarte (4368 in chips) 
Seat 6: kidritalina (8567 in chips) 
Seat 7: rebeLoNrun (5216 in chips) 
Seat 9: TheMagixFlop (4181 in chips) 
vectra79: posts the ante 25
ErikLarios2836: posts the ante 25
Caio Mugarte: posts the ante 25
kidritalina: posts the ante 25
rebeLoNrun: posts the ante 25
TheMagixFlop: posts the ante 25
vectra79: posts small blind 150
ErikLarios2836: posts big blind 300
*** HOLE CARDS ***
Dealt to Caio Mugarte [3h Tc]
Caio Mugarte: folds 
kidritalina: folds 
rebeLoNrun: folds 
TheMagixFlop: folds 
vectra79: raises 1062 to 1362 and is all-in
ErikLarios2836: folds 
Uncalled bet (1062) returned to vectra79
vectra79 collected 750 from pot
*** SUMMARY ***
Total pot 750 | Rake 0 
Seat 2: vectra79 (small blind) collected (750)
Seat 4: ErikLarios2836 (big blind) folded before Flop
Seat 5: Caio Mugarte folded before Flop (didn't bet)
Seat 6: kidritalina folded before Flop (didn't bet)
Seat 7: rebeLoNrun folded before Flop (didn't bet)
Seat 9: TheMagixFlop (button) folded before Flop (didn't bet)



PokerStars Hand #245447929320: Tournament #3632677041, $0.23+$0.02 USD Hold'em No Limit - Level VIII (150/300) - 2023/08/17 18:47:49 AT [2023/08/17 17:47:49 ET]
Table '3632677041 4' 9-max Seat #2 is the button
Seat 2: vectra79 (1812 in chips) 
Seat 4: ErikLarios2836 (2920 in chips) 
Seat 5: Caio Mugarte (4343 in chips) 
Seat 6: kidritalina (8542 in chips) 
Seat 7: rebeLoNrun (5191 in chips) 
Seat 9: TheMagixFlop (4156 in chips) 
vectra79: posts the ante 25
ErikLarios2836: posts the ante 25
Caio Mugarte: posts the ante 25
kidritalina: posts the ante 25
rebeLoNrun: posts the ante 25
TheMagixFlop: posts the ante 25
ErikLarios2836: posts small blind 150
Caio Mugarte: posts big blind 300
*** HOLE CARDS ***
Dealt to Caio Mugarte [Ks Ac]
kidritalina: folds 
rebeLoNrun: folds 
TheMagixFlop: folds 
vectra79: folds 
ErikLarios2836: calls 150
Caio Mugarte: raises 900 to 1200
ErikLarios2836: folds 
Uncalled bet (900) returned to Caio Mugarte
Caio Mugarte collected 750 from pot
Caio Mugarte: doesn't show hand 
*** SUMMARY ***
Total pot 750 | Rake 0 
Seat 2: vectra79 (button) folded before Flop (didn't bet)
Seat 4: ErikLarios2836 (small blind) folded before Flop
Seat 5: Caio Mugarte (big blind) collected (750)
Seat 6: kidritalina folded before Flop (didn't bet)
Seat 7: rebeLoNrun folded before Flop (didn't bet)
Seat 9: TheMagixFlop folded before Flop (didn't bet)



PokerStars Hand #245447937210: Tournament #3632677041, $0.23+$0.02 USD Hold'em No Limit - Level VIII (150/300) - 2023/08/17 18:48:14 AT [2023/08/17 17:48:14 ET]
Table '3632677041 4' 9-max Seat #4 is the button
Seat 2: vectra79 (1787 in chips) 
Seat 4: ErikLarios2836 (2595 in chips) 
Seat 5: Caio Mugarte (4768 in chips) 
Seat 6: kidritalina (8517 in chips) 
Seat 7: rebeLoNrun (5166 in chips) 
Seat 9: TheMagixFlop (4131 in chips) 
vectra79: posts the ante 25
ErikLarios2836: posts the ante 25
Caio Mugarte: posts the ante 25
kidritalina: posts the ante 25
rebeLoNrun: posts the ante 25
TheMagixFlop: posts the ante 25
Caio Mugarte: posts small blind 150
kidritalina: posts big blind 300
*** HOLE CARDS ***
Dealt to Caio Mugarte [3c 2h]
rebeLoNrun: raises 300 to 600
TheMagixFlop: folds 
vectra79: folds 
ErikLarios2836: folds 
Caio Mugarte: folds 
kidritalina: folds 
Uncalled bet (300) returned to rebeLoNrun
rebeLoNrun collected 900 from pot
*** SUMMARY ***
Total pot 900 | Rake 0 
Seat 2: vectra79 folded before Flop (didn't bet)
Seat 4: ErikLarios2836 (button) folded before Flop (didn't bet)
Seat 5: Caio Mugarte (small blind) folded before Flop
Seat 6: kidritalina (big blind) folded before Flop
Seat 7: rebeLoNrun collected (900)
Seat 9: TheMagixFlop folded before Flop (didn't bet)



PokerStars Hand #245447948829: Tournament #3632677041, $0.23+$0.02 USD Hold'em No Limit - Level VIII (150/300) - 2023/08/17 18:48:52 AT [2023/08/17 17:48:52 ET]
Table '3632677041 4' 9-max Seat #5 is the button
Seat 2: vectra79 (1762 in chips) 
Seat 4: ErikLarios2836 (2570 in chips) 
Seat 5: Caio Mugarte (4593 in chips) 
Seat 6: kidritalina (8192 in chips) 
Seat 7: rebeLoNrun (5741 in chips) 
Seat 9: TheMagixFlop (4106 in chips) 
vectra79: posts the ante 25
ErikLarios2836: posts the ante 25
Caio Mugarte: posts the ante 25
kidritalina: posts the ante 25
rebeLoNrun: posts the ante 25
TheMagixFlop: posts the ante 25
kidritalina: posts small blind 150
rebeLoNrun: posts big blind 300
*** HOLE CARDS ***
Dealt to Caio Mugarte [Qs 6h]
TheMagixFlop: folds 
vectra79: folds 
ErikLarios2836: folds 
Caio Mugarte: folds 
kidritalina: folds 
Uncalled bet (150) returned to rebeLoNrun
rebeLoNrun collected 450 from pot
*** SUMMARY ***
Total pot 450 | Rake 0 
Seat 2: vectra79 folded before Flop (didn't bet)
Seat 4: ErikLarios2836 folded before Flop (didn't bet)
Seat 5: Caio Mugarte (button) folded before Flop (didn't bet)
Seat 6: kidritalina (small blind) folded before Flop
Seat 7: rebeLoNrun (big blind) collected (450)
Seat 9: TheMagixFlop folded before Flop (didn't bet)



PokerStars Hand #245447952196: Tournament #3632677041, $0.23+$0.02 USD Hold'em No Limit - Level VIII (150/300) - 2023/08/17 18:49:02 AT [2023/08/17 17:49:02 ET]
Table '3632677041 4' 9-max Seat #6 is the button
Seat 2: vectra79 (1737 in chips) 
Seat 4: ErikLarios2836 (2545 in chips) 
Seat 5: Caio Mugarte (4568 in chips) 
Seat 6: kidritalina (8017 in chips) 
Seat 7: rebeLoNrun (6016 in chips) 
Seat 9: TheMagixFlop (4081 in chips) 
vectra79: posts the ante 25
ErikLarios2836: posts the ante 25
Caio Mugarte: posts the ante 25
kidritalina: posts the ante 25
rebeLoNrun: posts the ante 25
TheMagixFlop: posts the ante 25
rebeLoNrun: posts small blind 150
TheMagixFlop: posts big blind 300
*** HOLE CARDS ***
Dealt to Caio Mugarte [9d Ts]
vectra79: folds 
ErikLarios2836: folds 
Caio Mugarte: folds 
kidritalina: folds 
rebeLoNrun: folds 
Uncalled bet (150) returned to TheMagixFlop
TheMagixFlop collected 450 from pot
*** SUMMARY ***
Total pot 450 | Rake 0 
Seat 2: vectra79 folded before Flop (didn't bet)
Seat 4: ErikLarios2836 folded before Flop (didn't bet)
Seat 5: Caio Mugarte folded before Flop (didn't bet)
Seat 6: kidritalina (button) folded before Flop (didn't bet)
Seat 7: rebeLoNrun (small blind) folded before Flop
Seat 9: TheMagixFlop (big blind) collected (450)



PokerStars Hand #245447958112: Tournament #3632677041, $0.23+$0.02 USD Hold'em No Limit - Level VIII (150/300) - 2023/08/17 18:49:21 AT [2023/08/17 17:49:21 ET]
Table '3632677041 4' 9-max Seat #7 is the button
Seat 2: vectra79 (1712 in chips) 
Seat 4: ErikLarios2836 (2520 in chips) 
Seat 5: Caio Mugarte (4543 in chips) 
Seat 6: kidritalina (7992 in chips) 
Seat 7: rebeLoNrun (5841 in chips) 
Seat 9: TheMagixFlop (4356 in chips) 
vectra79: posts the ante 25
ErikLarios2836: posts the ante 25
Caio Mugarte: posts the ante 25
kidritalina: posts the ante 25
rebeLoNrun: posts the ante 25
TheMagixFlop: posts the ante 25
TheMagixFlop: posts small blind 150
vectra79: posts big blind 300
*** HOLE CARDS ***
Dealt to Caio Mugarte [Td 6h]
ErikLarios2836: folds 
Caio Mugarte: folds 
kidritalina: raises 7667 to 7967 and is all-in
rebeLoNrun: folds 
TheMagixFlop: folds 
vectra79: calls 1387 and is all-in
Uncalled bet (6280) returned to kidritalina
*** FLOP *** [Th 9c 4h]
*** TURN *** [Th 9c 4h] [2c]
*** RIVER *** [Th 9c 4h 2c] [2h]
*** SHOW DOWN ***
vectra79: shows [Qh Kc] (a pair of Deuces)
kidritalina: shows [7d 7h] (two pair, Sevens and Deuces)
kidritalina collected 3674 from pot
vectra79 finished the tournament in 12th place
*** SUMMARY ***
Total pot 3674 | Rake 0 
Board [Th 9c 4h 2c 2h]
Seat 2: vectra79 (big blind) showed [Qh Kc] and lost with a pair of Deuces
Seat 4: ErikLarios2836 folded before Flop (didn't bet)
Seat 5: Caio Mugarte folded before Flop (didn't bet)
Seat 6: kidritalina showed [7d 7h] and won (3674) with two pair, Sevens and Deuces
Seat 7: rebeLoNrun (button) folded before Flop (didn't bet)
Seat 9: TheMagixFlop (small blind) folded before Flop



PokerStars Hand #245447966273: Tournament #3632677041, $0.23+$0.02 USD Hold'em No Limit - Level IX (200/400) - 2023/08/17 18:49:48 AT [2023/08/17 17:49:48 ET]
Table '3632677041 4' 9-max Seat #9 is the button
Seat 4: ErikLarios2836 (2495 in chips) 
Seat 5: Caio Mugarte (4518 in chips) 
Seat 6: kidritalina (9954 in chips) 
Seat 7: rebeLoNrun (5816 in chips) 
Seat 9: TheMagixFlop (4181 in chips) 
ErikLarios2836: posts the ante 25
Caio Mugarte: posts the ante 25
kidritalina: posts the ante 25
rebeLoNrun: posts the ante 25
TheMagixFlop: posts the ante 25
ErikLarios2836: posts small blind 200
Caio Mugarte: posts big blind 400
*** HOLE CARDS ***
Dealt to Caio Mugarte [9h 9d]
kidritalina: folds 
rebeLoNrun: folds 
TheMagixFlop: folds 
ErikLarios2836: raises 2070 to 2470 and is all-in
Caio Mugarte: calls 2070
*** FLOP *** [Ad 2s Ah]
*** TURN *** [Ad 2s Ah] [7c]
*** RIVER *** [Ad 2s Ah 7c] [9s]
*** SHOW DOWN ***
ErikLarios2836: shows [Js 9c] (two pair, Aces and Nines)
Caio Mugarte: shows [9h 9d] (a full house, Nines full of Aces)
Caio Mugarte collected 5065 from pot
ErikLarios2836 finished the tournament in 11th place
*** SUMMARY ***
Total pot 5065 | Rake 0 
Board [Ad 2s Ah 7c 9s]
Seat 4: ErikLarios2836 (small blind) showed [Js 9c] and lost with two pair, Aces and Nines
Seat 5: Caio Mugarte (big blind) showed [9h 9d] and won (5065) with a full house, Nines full of Aces
Seat 6: kidritalina folded before Flop (didn't bet)
Seat 7: rebeLoNrun folded before Flop (didn't bet)
Seat 9: TheMagixFlop (button) folded before Flop (didn't bet)



PokerStars Hand #245447976868: Tournament #3632677041, $0.23+$0.02 USD Hold'em No Limit - Level IX (200/400) - 2023/08/17 18:50:21 AT [2023/08/17 17:50:21 ET]
Table '3632677041 4' 9-max Seat #5 is the button
Seat 5: Caio Mugarte (7088 in chips) 
Seat 6: kidritalina (9929 in chips) 
Seat 7: rebeLoNrun (5791 in chips) 
Seat 9: TheMagixFlop (4156 in chips) 
Caio Mugarte: posts the ante 25
kidritalina: posts the ante 25
rebeLoNrun: posts the ante 25
TheMagixFlop: posts the ante 25
kidritalina: posts small blind 200
rebeLoNrun: posts big blind 400
*** HOLE CARDS ***
Dealt to Caio Mugarte [Qd 8s]
SOY PATO355 is disconnected 
TheMagixFlop: folds 
Caio Mugarte: folds 
kidritalina: raises 400 to 800
rebeLoNrun: calls 400
*** FLOP *** [4d 4s 6d]
kidritalina: bets 850
rebeLoNrun: folds 
Uncalled bet (850) returned to kidritalina
kidritalina collected 1700 from pot
kidritalina: doesn't show hand 
*** SUMMARY ***
Total pot 1700 | Rake 0 
Board [4d 4s 6d]
Seat 5: Caio Mugarte (button) folded before Flop (didn't bet)
Seat 6: kidritalina (small blind) collected (1700)
Seat 7: rebeLoNrun (big blind) folded on the Flop
Seat 9: TheMagixFlop folded before Flop (didn't bet)



PokerStars Hand #245447983768: Tournament #3632677041, $0.23+$0.02 USD Hold'em No Limit - Level IX (200/400) - 2023/08/17 18:50:44 AT [2023/08/17 17:50:44 ET]
Table '3632677041 4' 9-max Seat #6 is the button
Seat 5: Caio Mugarte (7063 in chips) 
Seat 6: kidritalina (10804 in chips) 
Seat 7: rebeLoNrun (4966 in chips) 
Seat 8: SOY PATO355 (9067 in chips) 
Seat 9: TheMagixFlop (4131 in chips) 
Caio Mugarte: posts the ante 25
kidritalina: posts the ante 25
rebeLoNrun: posts the ante 25
SOY PATO355: posts the ante 25
TheMagixFlop: posts the ante 25
rebeLoNrun: posts small blind 200
SOY PATO355: posts big blind 400
*** HOLE CARDS ***
Dealt to Caio Mugarte [Kc 5c]
TheMagixFlop: folds 
Caio Mugarte: folds 
kidritalina: folds 
rebeLoNrun: raises 4541 to 4941 and is all-in
Vinteseis36 is disconnected 
SOY PATO355: folds 
Uncalled bet (4541) returned to rebeLoNrun
rebeLoNrun collected 925 from pot
*** SUMMARY ***
Total pot 925 | Rake 0 
Seat 5: Caio Mugarte folded before Flop (didn't bet)
Seat 6: kidritalina (button) folded before Flop (didn't bet)
Seat 7: rebeLoNrun (small blind) collected (925)
Seat 8: SOY PATO355 (big blind) folded before Flop
Seat 9: TheMagixFlop folded before Flop (didn't bet)



PokerStars Hand #245447992997: Tournament #3632677041, $0.23+$0.02 USD Hold'em No Limit - Level IX (200/400) - 2023/08/17 18:51:13 AT [2023/08/17 17:51:13 ET]
Table '3632677041 4' 9-max Seat #7 is the button
Seat 1: vishiwa (10092 in chips) 
Seat 2: Vinteseis36 (2501 in chips) 
Seat 3: frogz69 (4678 in chips) 
Seat 4: fmorandi (14198 in chips) 
Seat 5: Caio Mugarte (7038 in chips) 
Seat 6: kidritalina (10779 in chips) 
Seat 7: rebeLoNrun (5466 in chips) 
Seat 8: SOY PATO355 (8642 in chips) 
Seat 9: TheMagixFlop (4106 in chips) 
vishiwa: posts the ante 25
Vinteseis36: posts the ante 25
frogz69: posts the ante 25
fmorandi: posts the ante 25
Caio Mugarte: posts the ante 25
kidritalina: posts the ante 25
rebeLoNrun: posts the ante 25
SOY PATO355: posts the ante 25
TheMagixFlop: posts the ante 25
SOY PATO355: posts small blind 200
TheMagixFlop: posts big blind 400
*** HOLE CARDS ***
Dealt to Caio Mugarte [Td 5s]
vishiwa: folds 
Vinteseis36: folds 
frogz69: folds 
fmorandi: calls 400
Caio Mugarte: folds 
kidritalina: folds 
rebeLoNrun: folds 
SOY PATO355: calls 200
TheMagixFlop: checks 
*** FLOP *** [2d 6c Ac]
SOY PATO355: checks 
TheMagixFlop: checks 
fmorandi: checks 
*** TURN *** [2d 6c Ac] [Qd]
SOY PATO355: checks 
TheMagixFlop: checks 
fmorandi: checks 
*** RIVER *** [2d 6c Ac Qd] [7s]
SOY PATO355: checks 
TheMagixFlop: checks 
fmorandi: checks 
*** SHOW DOWN ***
SOY PATO355: shows [Tc 7c] (a pair of Sevens)
TheMagixFlop: mucks hand 
fmorandi: mucks hand 
SOY PATO355 collected 1425 from pot
*** SUMMARY ***
Total pot 1425 | Rake 0 
Board [2d 6c Ac Qd 7s]
Seat 1: vishiwa folded before Flop (didn't bet)
Seat 2: Vinteseis36 folded before Flop (didn't bet)
Seat 3: frogz69 folded before Flop (didn't bet)
Seat 4: fmorandi mucked [Th Jc]
Seat 5: Caio Mugarte folded before Flop (didn't bet)
Seat 6: kidritalina folded before Flop (didn't bet)
Seat 7: rebeLoNrun (button) folded before Flop (didn't bet)
Seat 8: SOY PATO355 (small blind) showed [Tc 7c] and won (1425) with a pair of Sevens
Seat 9: TheMagixFlop (big blind) mucked [4d 3c]



PokerStars Hand #245448008918: Tournament #3632677041, $0.23+$0.02 USD Hold'em No Limit - Level IX (200/400) - 2023/08/17 18:52:05 AT [2023/08/17 17:52:05 ET]
Table '3632677041 4' 9-max Seat #8 is the button
Seat 1: vishiwa (10067 in chips) 
Seat 2: Vinteseis36 (2476 in chips) 
Seat 3: frogz69 (4653 in chips) 
Seat 4: fmorandi (13773 in chips) 
Seat 5: Caio Mugarte (7013 in chips) 
Seat 6: kidritalina (10754 in chips) 
Seat 7: rebeLoNrun (5441 in chips) 
Seat 8: SOY PATO355 (9642 in chips) 
Seat 9: TheMagixFlop (3681 in chips) 
vishiwa: posts the ante 25
Vinteseis36: posts the ante 25
frogz69: posts the ante 25
fmorandi: posts the ante 25
Caio Mugarte: posts the ante 25
kidritalina: posts the ante 25
rebeLoNrun: posts the ante 25
SOY PATO355: posts the ante 25
TheMagixFlop: posts the ante 25
TheMagixFlop: posts small blind 200
vishiwa: posts big blind 400
*** HOLE CARDS ***
Dealt to Caio Mugarte [2s Ah]
Vinteseis36: folds 
frogz69: folds 
fmorandi: folds 
Caio Mugarte: folds 
kidritalina: raises 10329 to 10729 and is all-in
rebeLoNrun: folds 
SOY PATO355: folds 
TheMagixFlop: folds 
vishiwa: folds 
Uncalled bet (10329) returned to kidritalina
kidritalina collected 1225 from pot
kidritalina: doesn't show hand 
*** SUMMARY ***
Total pot 1225 | Rake 0 
Seat 1: vishiwa (big blind) folded before Flop
Seat 2: Vinteseis36 folded before Flop (didn't bet)
Seat 3: frogz69 folded before Flop (didn't bet)
Seat 4: fmorandi folded before Flop (didn't bet)
Seat 5: Caio Mugarte folded before Flop (didn't bet)
Seat 6: kidritalina collected (1225)
Seat 7: rebeLoNrun folded before Flop (didn't bet)
Seat 8: SOY PATO355 (button) folded before Flop (didn't bet)
Seat 9: TheMagixFlop (small blind) folded before Flop



PokerStars Hand #245448016464: Tournament #3632677041, $0.23+$0.02 USD Hold'em No Limit - Level IX (200/400) - 2023/08/17 18:52:29 AT [2023/08/17 17:52:29 ET]
Table '3632677041 4' 9-max Seat #9 is the button
Seat 1: vishiwa (9642 in chips) 
Seat 2: Vinteseis36 (2451 in chips) 
Seat 3: frogz69 (4628 in chips) 
Seat 4: fmorandi (13748 in chips) 
Seat 5: Caio Mugarte (6988 in chips) 
Seat 6: kidritalina (11554 in chips) 
Seat 7: rebeLoNrun (5416 in chips) 
Seat 8: SOY PATO355 (9617 in chips) 
Seat 9: TheMagixFlop (3456 in chips) 
vishiwa: posts the ante 25
Vinteseis36: posts the ante 25
frogz69: posts the ante 25
fmorandi: posts the ante 25
Caio Mugarte: posts the ante 25
kidritalina: posts the ante 25
rebeLoNrun: posts the ante 25
SOY PATO355: posts the ante 25
TheMagixFlop: posts the ante 25
vishiwa: posts small blind 200
Vinteseis36: posts big blind 400
*** HOLE CARDS ***
Dealt to Caio Mugarte [9d 2s]
frogz69: folds 
fmorandi: calls 400
Caio Mugarte: folds 
kidritalina: folds 
rebeLoNrun: folds 
SOY PATO355: folds 
TheMagixFlop is disconnected 
TheMagixFlop is connected 
TheMagixFlop is disconnected 
TheMagixFlop is connected 
TheMagixFlop is connected 
TheMagixFlop is connected 
TheMagixFlop: folds 
vishiwa: calls 200
Vinteseis36: checks 
*** FLOP *** [9h 4d As]
vishiwa: checks 
Vinteseis36: bets 2026 and is all-in
fmorandi: calls 2026
vishiwa: folds 
*** TURN *** [9h 4d As] [Tc]
*** RIVER *** [9h 4d As Tc] [2c]
*** SHOW DOWN ***
Vinteseis36: shows [9c 4s] (two pair, Nines and Fours)
fmorandi: shows [Ah 7s] (a pair of Aces)
Vinteseis36 collected 5477 from pot
*** SUMMARY ***
Total pot 5477 | Rake 0 
Board [9h 4d As Tc 2c]
Seat 1: vishiwa (small blind) folded on the Flop
Seat 2: Vinteseis36 (big blind) showed [9c 4s] and won (5477) with two pair, Nines and Fours
Seat 3: frogz69 folded before Flop (didn't bet)
Seat 4: fmorandi showed [Ah 7s] and lost with a pair of Aces
Seat 5: Caio Mugarte folded before Flop (didn't bet)
Seat 6: kidritalina folded before Flop (didn't bet)
Seat 7: rebeLoNrun folded before Flop (didn't bet)
Seat 8: SOY PATO355 folded before Flop (didn't bet)
Seat 9: TheMagixFlop (button) folded before Flop (didn't bet)



PokerStars Hand #245448039017: Tournament #3632677041, $0.23+$0.02 USD Hold'em No Limit - Level IX (200/400) - 2023/08/17 18:53:42 AT [2023/08/17 17:53:42 ET]
Table '3632677041 4' 9-max Seat #1 is the button
Seat 1: vishiwa (9217 in chips) 
Seat 2: Vinteseis36 (5477 in chips) 
Seat 3: frogz69 (4603 in chips) 
Seat 4: fmorandi (11297 in chips) 
Seat 5: Caio Mugarte (6963 in chips) 
Seat 6: kidritalina (11529 in chips) 
Seat 7: rebeLoNrun (5391 in chips) 
Seat 8: SOY PATO355 (9592 in chips) 
Seat 9: TheMagixFlop (3431 in chips) 
vishiwa: posts the ante 25
Vinteseis36: posts the ante 25
frogz69: posts the ante 25
fmorandi: posts the ante 25
Caio Mugarte: posts the ante 25
kidritalina: posts the ante 25
rebeLoNrun: posts the ante 25
SOY PATO355: posts the ante 25
TheMagixFlop: posts the ante 25
Vinteseis36: posts small blind 200
frogz69: posts big blind 400
*** HOLE CARDS ***
Dealt to Caio Mugarte [Jc 8c]
fmorandi: folds 
Caio Mugarte: folds 
kidritalina: folds 
rebeLoNrun: folds 
SOY PATO355: folds 
TheMagixFlop: folds 
vishiwa: raises 400 to 800
Vinteseis36: folds 
frogz69: folds 
Uncalled bet (400) returned to vishiwa
vishiwa collected 1225 from pot
vishiwa: doesn't show hand 
*** SUMMARY ***
Total pot 1225 | Rake 0 
Seat 1: vishiwa (button) collected (1225)
Seat 2: Vinteseis36 (small blind) folded before Flop
Seat 3: frogz69 (big blind) folded before Flop
Seat 4: fmorandi folded before Flop (didn't bet)
Seat 5: Caio Mugarte folded before Flop (didn't bet)
Seat 6: kidritalina folded before Flop (didn't bet)
Seat 7: rebeLoNrun folded before Flop (didn't bet)
Seat 8: SOY PATO355 folded before Flop (didn't bet)
Seat 9: TheMagixFlop folded before Flop (didn't bet)



PokerStars Hand #245448045436: Tournament #3632677041, $0.23+$0.02 USD Hold'em No Limit - Level IX (200/400) - 2023/08/17 18:54:02 AT [2023/08/17 17:54:02 ET]
Table '3632677041 4' 9-max Seat #2 is the button
Seat 1: vishiwa (10017 in chips) 
Seat 2: Vinteseis36 (5252 in chips) 
Seat 3: frogz69 (4178 in chips) 
Seat 4: fmorandi (11272 in chips) 
Seat 5: Caio Mugarte (6938 in chips) 
Seat 6: kidritalina (11504 in chips) 
Seat 7: rebeLoNrun (5366 in chips) 
Seat 8: SOY PATO355 (9567 in chips) 
Seat 9: TheMagixFlop (3406 in chips) 
vishiwa: posts the ante 25
Vinteseis36: posts the ante 25
frogz69: posts the ante 25
fmorandi: posts the ante 25
Caio Mugarte: posts the ante 25
kidritalina: posts the ante 25
rebeLoNrun: posts the ante 25
SOY PATO355: posts the ante 25
TheMagixFlop: posts the ante 25
frogz69: posts small blind 200
fmorandi: posts big blind 400
*** HOLE CARDS ***
Dealt to Caio Mugarte [Kd 7c]
Caio Mugarte: folds 
kidritalina: folds 
rebeLoNrun: folds 
SOY PATO355: folds 
TheMagixFlop: folds 
vishiwa: folds 
Vinteseis36: folds 
frogz69: calls 200
fmorandi: raises 400 to 800
frogz69: raises 1200 to 2000
fmorandi: calls 1200
*** FLOP *** [Ah Kh 8s]
frogz69: bets 2153 and is all-in
fmorandi: folds 
Uncalled bet (2153) returned to frogz69
frogz69 collected 4225 from pot
frogz69: doesn't show hand 
*** SUMMARY ***
Total pot 4225 | Rake 0 
Board [Ah Kh 8s]
Seat 1: vishiwa folded before Flop (didn't bet)
Seat 2: Vinteseis36 (button) folded before Flop (didn't bet)
Seat 3: frogz69 (small blind) collected (4225)
Seat 4: fmorandi (big blind) folded on the Flop
Seat 5: Caio Mugarte folded before Flop (didn't bet)
Seat 6: kidritalina folded before Flop (didn't bet)
Seat 7: rebeLoNrun folded before Flop (didn't bet)
Seat 8: SOY PATO355 folded before Flop (didn't bet)
Seat 9: TheMagixFlop folded before Flop (didn't bet)



PokerStars Hand #245448058545: Tournament #3632677041, $0.23+$0.02 USD Hold'em No Limit - Level IX (200/400) - 2023/08/17 18:54:46 AT [2023/08/17 17:54:46 ET]
Table '3632677041 4' 9-max Seat #3 is the button
Seat 1: vishiwa (9992 in chips) 
Seat 2: Vinteseis36 (5227 in chips) 
Seat 3: frogz69 (6378 in chips) 
Seat 4: fmorandi (9247 in chips) 
Seat 5: Caio Mugarte (6913 in chips) 
Seat 6: kidritalina (11479 in chips) 
Seat 7: rebeLoNrun (5341 in chips) 
Seat 8: SOY PATO355 (9542 in chips) 
Seat 9: TheMagixFlop (3381 in chips) 
vishiwa: posts the ante 25
Vinteseis36: posts the ante 25
frogz69: posts the ante 25
fmorandi: posts the ante 25
Caio Mugarte: posts the ante 25
kidritalina: posts the ante 25
rebeLoNrun: posts the ante 25
SOY PATO355: posts the ante 25
TheMagixFlop: posts the ante 25
fmorandi: posts small blind 200
Caio Mugarte: posts big blind 400
*** HOLE CARDS ***
Dealt to Caio Mugarte [4c 9c]
kidritalina: folds 
rebeLoNrun: folds 
SOY PATO355: folds 
TheMagixFlop: folds 
vishiwa: folds 
Vinteseis36: folds 
frogz69: folds 
fmorandi: calls 200
Caio Mugarte: checks 
*** FLOP *** [5d 7h Qh]
fmorandi: checks 
Caio Mugarte: checks 
*** TURN *** [5d 7h Qh] [2c]
fmorandi: checks 
Caio Mugarte: checks 
*** RIVER *** [5d 7h Qh 2c] [8c]
fmorandi: checks 
Caio Mugarte: checks 
*** SHOW DOWN ***
fmorandi: shows [Jd 4d] (high card Queen)
Caio Mugarte: mucks hand 
fmorandi collected 1025 from pot
*** SUMMARY ***
Total pot 1025 | Rake 0 
Board [5d 7h Qh 2c 8c]
Seat 1: vishiwa folded before Flop (didn't bet)
Seat 2: Vinteseis36 folded before Flop (didn't bet)
Seat 3: frogz69 (button) folded before Flop (didn't bet)
Seat 4: fmorandi (small blind) showed [Jd 4d] and won (1025) with high card Queen
Seat 5: Caio Mugarte (big blind) mucked [4c 9c]
Seat 6: kidritalina folded before Flop (didn't bet)
Seat 7: rebeLoNrun folded before Flop (didn't bet)
Seat 8: SOY PATO355 folded before Flop (didn't bet)
Seat 9: TheMagixFlop folded before Flop (didn't bet)



PokerStars Hand #245448140968: Tournament #3632677041, $0.23+$0.02 USD Hold'em No Limit - Level IX (200/400) - 2023/08/17 19:00:22 AT [2023/08/17 18:00:22 ET]
Table '3632677041 4' 9-max Seat #4 is the button
Seat 1: vishiwa (9967 in chips) 
Seat 2: Vinteseis36 (5202 in chips) 
Seat 3: frogz69 (6353 in chips) 
Seat 4: fmorandi (9847 in chips) 
Seat 5: Caio Mugarte (6488 in chips) 
Seat 6: kidritalina (11454 in chips) 
Seat 7: rebeLoNrun (5316 in chips) 
Seat 8: SOY PATO355 (9517 in chips) 
Seat 9: TheMagixFlop (3356 in chips) 
vishiwa: posts the ante 25
Vinteseis36: posts the ante 25
frogz69: posts the ante 25
fmorandi: posts the ante 25
Caio Mugarte: posts the ante 25
kidritalina: posts the ante 25
rebeLoNrun: posts the ante 25
SOY PATO355: posts the ante 25
TheMagixFlop: posts the ante 25
Caio Mugarte: posts small blind 200
kidritalina: posts big blind 400
*** HOLE CARDS ***
Dealt to Caio Mugarte [Td Qc]
rebeLoNrun: folds 
SOY PATO355: calls 400
TheMagixFlop is connected 
TheMagixFlop is connected 
TheMagixFlop: folds 
vishiwa: folds 
Vinteseis36: folds 
frogz69: folds 
fmorandi: folds 
Caio Mugarte: calls 200
kidritalina: checks 
*** FLOP *** [6d As Ac]
Caio Mugarte: checks 
kidritalina: checks 
SOY PATO355: bets 400
Caio Mugarte: folds 
kidritalina: folds 
Uncalled bet (400) returned to SOY PATO355
SOY PATO355 collected 1425 from pot
SOY PATO355: doesn't show hand 
*** SUMMARY ***
Total pot 1425 | Rake 0 
Board [6d As Ac]
Seat 1: vishiwa folded before Flop (didn't bet)
Seat 2: Vinteseis36 folded before Flop (didn't bet)
Seat 3: frogz69 folded before Flop (didn't bet)
Seat 4: fmorandi (button) folded before Flop (didn't bet)
Seat 5: Caio Mugarte (small blind) folded on the Flop
Seat 6: kidritalina (big blind) folded on the Flop
Seat 7: rebeLoNrun folded before Flop (didn't bet)
Seat 8: SOY PATO355 collected (1425)
Seat 9: TheMagixFlop folded before Flop (didn't bet)



PokerStars Hand #245448157231: Tournament #3632677041, $0.23+$0.02 USD Hold'em No Limit - Level IX (200/400) - 2023/08/17 19:01:21 AT [2023/08/17 18:01:21 ET]
Table '3632677041 4' 9-max Seat #5 is the button
Seat 1: vishiwa (9942 in chips) 
Seat 2: Vinteseis36 (5177 in chips) 
Seat 3: frogz69 (6328 in chips) 
Seat 4: fmorandi (9822 in chips) 
Seat 5: Caio Mugarte (6063 in chips) 
Seat 6: kidritalina (11029 in chips) 
Seat 7: rebeLoNrun (5291 in chips) 
Seat 8: SOY PATO355 (10517 in chips) 
Seat 9: TheMagixFlop (3331 in chips) 
vishiwa: posts the ante 25
Vinteseis36: posts the ante 25
frogz69: posts the ante 25
fmorandi: posts the ante 25
Caio Mugarte: posts the ante 25
kidritalina: posts the ante 25
rebeLoNrun: posts the ante 25
SOY PATO355: posts the ante 25
TheMagixFlop: posts the ante 25
kidritalina: posts small blind 200
rebeLoNrun: posts big blind 400
*** HOLE CARDS ***
Dealt to Caio Mugarte [3c Ac]
SOY PATO355: folds 
TheMagixFlop: folds 
vishiwa: folds 
Vinteseis36: folds 
frogz69: folds 
fmorandi: folds 
Caio Mugarte: raises 400 to 800
kidritalina: folds 
rebeLoNrun: folds 
Uncalled bet (400) returned to Caio Mugarte
Caio Mugarte collected 1225 from pot
Caio Mugarte: doesn't show hand 
*** SUMMARY ***
Total pot 1225 | Rake 0 
Seat 1: vishiwa folded before Flop (didn't bet)
Seat 2: Vinteseis36 folded before Flop (didn't bet)
Seat 3: frogz69 folded before Flop (didn't bet)
Seat 4: fmorandi folded before Flop (didn't bet)
Seat 5: Caio Mugarte (button) collected (1225)
Seat 6: kidritalina (small blind) folded before Flop
Seat 7: rebeLoNrun (big blind) folded before Flop
Seat 8: SOY PATO355 folded before Flop (didn't bet)
Seat 9: TheMagixFlop folded before Flop (didn't bet)



PokerStars Hand #245448162552: Tournament #3632677041, $0.23+$0.02 USD Hold'em No Limit - Level IX (200/400) - 2023/08/17 19:01:40 AT [2023/08/17 18:01:40 ET]
Table '3632677041 4' 9-max Seat #6 is the button
Seat 1: vishiwa (9917 in chips) 
Seat 2: Vinteseis36 (5152 in chips) 
Seat 3: frogz69 (6303 in chips) 
Seat 4: fmorandi (9797 in chips) 
Seat 5: Caio Mugarte (6863 in chips) 
Seat 6: kidritalina (10804 in chips) 
Seat 7: rebeLoNrun (4866 in chips) 
Seat 8: SOY PATO355 (10492 in chips) 
Seat 9: TheMagixFlop (3306 in chips) 
vishiwa: posts the ante 25
Vinteseis36: posts the ante 25
frogz69: posts the ante 25
fmorandi: posts the ante 25
Caio Mugarte: posts the ante 25
kidritalina: posts the ante 25
rebeLoNrun: posts the ante 25
SOY PATO355: posts the ante 25
TheMagixFlop: posts the ante 25
rebeLoNrun: posts small blind 200
SOY PATO355: posts big blind 400
*** HOLE CARDS ***
Dealt to Caio Mugarte [6d Js]
TheMagixFlop: raises 2881 to 3281 and is all-in
vishiwa: folds 
Vinteseis36: folds 
frogz69: folds 
fmorandi: folds 
Caio Mugarte: folds 
kidritalina: folds 
rebeLoNrun: folds 
SOY PATO355: folds 
Uncalled bet (2881) returned to TheMagixFlop
TheMagixFlop collected 1225 from pot
*** SUMMARY ***
Total pot 1225 | Rake 0 
Seat 1: vishiwa folded before Flop (didn't bet)
Seat 2: Vinteseis36 folded before Flop (didn't bet)
Seat 3: frogz69 folded before Flop (didn't bet)
Seat 4: fmorandi folded before Flop (didn't bet)
Seat 5: Caio Mugarte folded before Flop (didn't bet)
Seat 6: kidritalina (button) folded before Flop (didn't bet)
Seat 7: rebeLoNrun (small blind) folded before Flop
Seat 8: SOY PATO355 (big blind) folded before Flop
Seat 9: TheMagixFlop collected (1225)



PokerStars Hand #245448170038: Tournament #3632677041, $0.23+$0.02 USD Hold'em No Limit - Level IX (200/400) - 2023/08/17 19:02:06 AT [2023/08/17 18:02:06 ET]
Table '3632677041 4' 9-max Seat #7 is the button
Seat 1: vishiwa (9892 in chips) 
Seat 2: Vinteseis36 (5127 in chips) 
Seat 3: frogz69 (6278 in chips) 
Seat 4: fmorandi (9772 in chips) 
Seat 5: Caio Mugarte (6838 in chips) 
Seat 6: kidritalina (10779 in chips) 
Seat 7: rebeLoNrun (4641 in chips) 
Seat 8: SOY PATO355 (10067 in chips) 
Seat 9: TheMagixFlop (4106 in chips) 
vishiwa: posts the ante 25
Vinteseis36: posts the ante 25
frogz69: posts the ante 25
fmorandi: posts the ante 25
Caio Mugarte: posts the ante 25
kidritalina: posts the ante 25
rebeLoNrun: posts the ante 25
SOY PATO355: posts the ante 25
TheMagixFlop: posts the ante 25
SOY PATO355: posts small blind 200
TheMagixFlop: posts big blind 400
*** HOLE CARDS ***
Dealt to Caio Mugarte [5c 6c]
vishiwa: folds 
Vinteseis36: folds 
frogz69: folds 
fmorandi: folds 
Caio Mugarte: folds 
kidritalina: folds 
rebeLoNrun: folds 
SOY PATO355: raises 400 to 800
TheMagixFlop: folds 
Uncalled bet (400) returned to SOY PATO355
SOY PATO355 collected 1025 from pot
SOY PATO355: doesn't show hand 
*** SUMMARY ***
Total pot 1025 | Rake 0 
Seat 1: vishiwa folded before Flop (didn't bet)
Seat 2: Vinteseis36 folded before Flop (didn't bet)
Seat 3: frogz69 folded before Flop (didn't bet)
Seat 4: fmorandi folded before Flop (didn't bet)
Seat 5: Caio Mugarte folded before Flop (didn't bet)
Seat 6: kidritalina folded before Flop (didn't bet)
Seat 7: rebeLoNrun (button) folded before Flop (didn't bet)
Seat 8: SOY PATO355 (small blind) collected (1025)
Seat 9: TheMagixFlop (big blind) folded before Flop



PokerStars Hand #245448179433: Tournament #3632677041, $0.23+$0.02 USD Hold'em No Limit - Level IX (200/400) - 2023/08/17 19:02:37 AT [2023/08/17 18:02:37 ET]
Table '3632677041 4' 9-max Seat #8 is the button
Seat 1: vishiwa (9867 in chips) 
Seat 2: Vinteseis36 (5102 in chips) 
Seat 3: frogz69 (6253 in chips) 
Seat 4: fmorandi (9747 in chips) 
Seat 5: Caio Mugarte (6813 in chips) 
Seat 6: kidritalina (10754 in chips) 
Seat 7: rebeLoNrun (4616 in chips) 
Seat 8: SOY PATO355 (10667 in chips) 
Seat 9: TheMagixFlop (3681 in chips) 
vishiwa: posts the ante 25
Vinteseis36: posts the ante 25
frogz69: posts the ante 25
fmorandi: posts the ante 25
Caio Mugarte: posts the ante 25
kidritalina: posts the ante 25
rebeLoNrun: posts the ante 25
SOY PATO355: posts the ante 25
TheMagixFlop: posts the ante 25
TheMagixFlop: posts small blind 200
vishiwa: posts big blind 400
*** HOLE CARDS ***
Dealt to Caio Mugarte [Tc 5s]
Vinteseis36: raises 400 to 800
frogz69: folds 
fmorandi: folds 
Caio Mugarte: folds 
kidritalina: folds 
rebeLoNrun: folds 
SOY PATO355: folds 
TheMagixFlop: folds 
vishiwa: calls 400
*** FLOP *** [Qd Jh 8c]
vishiwa: checks 
Vinteseis36: bets 1013
vishiwa: folds 
Uncalled bet (1013) returned to Vinteseis36
Vinteseis36 collected 2025 from pot
Vinteseis36: doesn't show hand 
*** SUMMARY ***
Total pot 2025 | Rake 0 
Board [Qd Jh 8c]
Seat 1: vishiwa (big blind) folded on the Flop
Seat 2: Vinteseis36 collected (2025)
Seat 3: frogz69 folded before Flop (didn't bet)
Seat 4: fmorandi folded before Flop (didn't bet)
Seat 5: Caio Mugarte folded before Flop (didn't bet)
Seat 6: kidritalina folded before Flop (didn't bet)
Seat 7: rebeLoNrun folded before Flop (didn't bet)
Seat 8: SOY PATO355 (button) folded before Flop (didn't bet)
Seat 9: TheMagixFlop (small blind) folded before Flop



PokerStars Hand #245448194321: Tournament #3632677041, $0.23+$0.02 USD Hold'em No Limit - Level IX (200/400) - 2023/08/17 19:03:27 AT [2023/08/17 18:03:27 ET]
Table '3632677041 4' 9-max Seat #9 is the button
Seat 1: vishiwa (9042 in chips) 
Seat 2: Vinteseis36 (6302 in chips) 
Seat 3: frogz69 (6228 in chips) 
Seat 4: fmorandi (9722 in chips) 
Seat 5: Caio Mugarte (6788 in chips) 
Seat 6: kidritalina (10729 in chips) 
Seat 7: rebeLoNrun (4591 in chips) 
Seat 8: SOY PATO355 (10642 in chips) 
Seat 9: TheMagixFlop (3456 in chips) 
vishiwa: posts the ante 25
Vinteseis36: posts the ante 25
frogz69: posts the ante 25
fmorandi: posts the ante 25
Caio Mugarte: posts the ante 25
kidritalina: posts the ante 25
rebeLoNrun: posts the ante 25
SOY PATO355: posts the ante 25
TheMagixFlop: posts the ante 25
vishiwa: posts small blind 200
Vinteseis36: posts big blind 400
*** HOLE CARDS ***
Dealt to Caio Mugarte [Td Jc]
frogz69: folds 
fmorandi: folds 
Caio Mugarte: folds 
kidritalina: folds 
rebeLoNrun: raises 4166 to 4566 and is all-in
SOY PATO355: folds 
TheMagixFlop: folds 
vishiwa: folds 
Vinteseis36: folds 
Uncalled bet (4166) returned to rebeLoNrun
rebeLoNrun collected 1225 from pot
*** SUMMARY ***
Total pot 1225 | Rake 0 
Seat 1: vishiwa (small blind) folded before Flop
Seat 2: Vinteseis36 (big blind) folded before Flop
Seat 3: frogz69 folded before Flop (didn't bet)
Seat 4: fmorandi folded before Flop (didn't bet)
Seat 5: Caio Mugarte folded before Flop (didn't bet)
Seat 6: kidritalina folded before Flop (didn't bet)
Seat 7: rebeLoNrun collected (1225)
Seat 8: SOY PATO355 folded before Flop (didn't bet)
Seat 9: TheMagixFlop (button) folded before Flop (didn't bet)



PokerStars Hand #245448200134: Tournament #3632677041, $0.23+$0.02 USD Hold'em No Limit - Level IX (200/400) - 2023/08/17 19:03:46 AT [2023/08/17 18:03:46 ET]
Table '3632677041 4' 9-max Seat #1 is the button
Seat 1: vishiwa (8817 in chips) 
Seat 2: Vinteseis36 (5877 in chips) 
Seat 3: frogz69 (6203 in chips) 
Seat 4: fmorandi (9697 in chips) 
Seat 5: Caio Mugarte (6763 in chips) 
Seat 6: kidritalina (10704 in chips) 
Seat 7: rebeLoNrun (5391 in chips) 
Seat 8: SOY PATO355 (10617 in chips) 
Seat 9: TheMagixFlop (3431 in chips) 
vishiwa: posts the ante 25
Vinteseis36: posts the ante 25
frogz69: posts the ante 25
fmorandi: posts the ante 25
Caio Mugarte: posts the ante 25
kidritalina: posts the ante 25
rebeLoNrun: posts the ante 25
SOY PATO355: posts the ante 25
TheMagixFlop: posts the ante 25
Vinteseis36: posts small blind 200
frogz69: posts big blind 400
*** HOLE CARDS ***
Dealt to Caio Mugarte [5s Jc]
fmorandi: folds 
Caio Mugarte: folds 
kidritalina: folds 
rebeLoNrun: folds 
SOY PATO355: folds 
TheMagixFlop: folds 
vishiwa: folds 
Vinteseis36: folds 
Uncalled bet (200) returned to frogz69
frogz69 collected 625 from pot
frogz69: doesn't show hand 
*** SUMMARY ***
Total pot 625 | Rake 0 
Seat 1: vishiwa (button) folded before Flop (didn't bet)
Seat 2: Vinteseis36 (small blind) folded before Flop
Seat 3: frogz69 (big blind) collected (625)
Seat 4: fmorandi folded before Flop (didn't bet)
Seat 5: Caio Mugarte folded before Flop (didn't bet)
Seat 6: kidritalina folded before Flop (didn't bet)
Seat 7: rebeLoNrun folded before Flop (didn't bet)
Seat 8: SOY PATO355 folded before Flop (didn't bet)
Seat 9: TheMagixFlop folded before Flop (didn't bet)



PokerStars Hand #245448204623: Tournament #3632677041, $0.23+$0.02 USD Hold'em No Limit - Level IX (200/400) - 2023/08/17 19:04:01 AT [2023/08/17 18:04:01 ET]
Table '3632677041 4' 9-max Seat #2 is the button
Seat 1: vishiwa (8792 in chips) 
Seat 2: Vinteseis36 (5652 in chips) 
Seat 3: frogz69 (6603 in chips) 
Seat 4: fmorandi (9672 in chips) 
Seat 5: Caio Mugarte (6738 in chips) 
Seat 6: kidritalina (10679 in chips) 
Seat 7: rebeLoNrun (5366 in chips) 
Seat 8: SOY PATO355 (10592 in chips) 
Seat 9: TheMagixFlop (3406 in chips) 
vishiwa: posts the ante 25
Vinteseis36: posts the ante 25
frogz69: posts the ante 25
fmorandi: posts the ante 25
Caio Mugarte: posts the ante 25
kidritalina: posts the ante 25
rebeLoNrun: posts the ante 25
SOY PATO355: posts the ante 25
TheMagixFlop: posts the ante 25
frogz69: posts small blind 200
fmorandi: posts big blind 400
*** HOLE CARDS ***
Dealt to Caio Mugarte [5s 9s]
Caio Mugarte: folds 
kidritalina: folds 
rebeLoNrun: raises 800 to 1200
SOY PATO355: folds 
TheMagixFlop: folds 
vishiwa: folds 
Vinteseis36: folds 
frogz69: folds 
fmorandi: calls 800
*** FLOP *** [2c 9c 6h]
fmorandi: checks 
rebeLoNrun: bets 4141 and is all-in
fmorandi: folds 
Uncalled bet (4141) returned to rebeLoNrun
rebeLoNrun collected 2825 from pot
*** SUMMARY ***
Total pot 2825 | Rake 0 
Board [2c 9c 6h]
Seat 1: vishiwa folded before Flop (didn't bet)
Seat 2: Vinteseis36 (button) folded before Flop (didn't bet)
Seat 3: frogz69 (small blind) folded before Flop
Seat 4: fmorandi (big blind) folded on the Flop
Seat 5: Caio Mugarte folded before Flop (didn't bet)
Seat 6: kidritalina folded before Flop (didn't bet)
Seat 7: rebeLoNrun collected (2825)
Seat 8: SOY PATO355 folded before Flop (didn't bet)
Seat 9: TheMagixFlop folded before Flop (didn't bet)



PokerStars Hand #245448215849: Tournament #3632677041, $0.23+$0.02 USD Hold'em No Limit - Level IX (200/400) - 2023/08/17 19:04:38 AT [2023/08/17 18:04:38 ET]
Table '3632677041 4' 9-max Seat #3 is the button
Seat 1: vishiwa (8767 in chips) 
Seat 2: Vinteseis36 (5627 in chips) 
Seat 3: frogz69 (6378 in chips) 
Seat 4: fmorandi (8447 in chips) 
Seat 5: Caio Mugarte (6713 in chips) 
Seat 6: kidritalina (10654 in chips) 
Seat 7: rebeLoNrun (6966 in chips) 
Seat 8: SOY PATO355 (10567 in chips) 
Seat 9: TheMagixFlop (3381 in chips) 
vishiwa: posts the ante 25
Vinteseis36: posts the ante 25
frogz69: posts the ante 25
fmorandi: posts the ante 25
Caio Mugarte: posts the ante 25
kidritalina: posts the ante 25
rebeLoNrun: posts the ante 25
SOY PATO355: posts the ante 25
TheMagixFlop: posts the ante 25
fmorandi: posts small blind 200
Caio Mugarte: posts big blind 400
*** HOLE CARDS ***
Dealt to Caio Mugarte [Kd 2d]
kidritalina: folds 
rebeLoNrun: folds 
SOY PATO355: folds 
TheMagixFlop: folds 
vishiwa: folds 
Vinteseis36: folds 
frogz69: folds 
fmorandi: raises 400 to 800
Caio Mugarte: calls 400
*** FLOP *** [Kc 9h As]
fmorandi: checks 
Caio Mugarte: bets 602
fmorandi: calls 602
*** TURN *** [Kc 9h As] [Qs]
fmorandi: checks 
Caio Mugarte: checks 
*** RIVER *** [Kc 9h As Qs] [Jc]
fmorandi: checks 
Caio Mugarte: checks 
*** SHOW DOWN ***
fmorandi: shows [4s Kh] (a pair of Kings)
Caio Mugarte: shows [Kd 2d] (a pair of Kings)
fmorandi collected 1515 from pot
Caio Mugarte collected 1514 from pot
*** SUMMARY ***
Total pot 3029 | Rake 0 
Board [Kc 9h As Qs Jc]
Seat 1: vishiwa folded before Flop (didn't bet)
Seat 2: Vinteseis36 folded before Flop (didn't bet)
Seat 3: frogz69 (button) folded before Flop (didn't bet)
Seat 4: fmorandi (small blind) showed [4s Kh] and won (1515) with a pair of Kings
Seat 5: Caio Mugarte (big blind) showed [Kd 2d] and won (1514) with a pair of Kings
Seat 6: kidritalina folded before Flop (didn't bet)
Seat 7: rebeLoNrun folded before Flop (didn't bet)
Seat 8: SOY PATO355 folded before Flop (didn't bet)
Seat 9: TheMagixFlop folded before Flop (didn't bet)



PokerStars Hand #245448229265: Tournament #3632677041, $0.23+$0.02 USD Hold'em No Limit - Level X (300/600) - 2023/08/17 19:05:22 AT [2023/08/17 18:05:22 ET]
Table '3632677041 4' 9-max Seat #4 is the button
Seat 1: vishiwa (8742 in chips) 
Seat 2: Vinteseis36 (5602 in chips) 
Seat 3: frogz69 (6353 in chips) 
Seat 4: fmorandi (8535 in chips) 
Seat 5: Caio Mugarte (6800 in chips) 
Seat 6: kidritalina (10629 in chips) 
Seat 7: rebeLoNrun (6941 in chips) 
Seat 8: SOY PATO355 (10542 in chips) 
Seat 9: TheMagixFlop (3356 in chips) 
vishiwa: posts the ante 50
Vinteseis36: posts the ante 50
frogz69: posts the ante 50
fmorandi: posts the ante 50
Caio Mugarte: posts the ante 50
kidritalina: posts the ante 50
rebeLoNrun: posts the ante 50
SOY PATO355: posts the ante 50
TheMagixFlop: posts the ante 50
Caio Mugarte: posts small blind 300
kidritalina: posts big blind 600
*** HOLE CARDS ***
Dealt to Caio Mugarte [6s 9s]
rebeLoNrun: folds 
SOY PATO355: folds 
TheMagixFlop: folds 
vishiwa: folds 
Vinteseis36: folds 
frogz69: folds 
fmorandi: folds 
Caio Mugarte: calls 300
kidritalina: checks 
*** FLOP *** [Kd 4d Qd]
Caio Mugarte: checks 
kidritalina: bets 825
Caio Mugarte: folds 
Uncalled bet (825) returned to kidritalina
kidritalina collected 1650 from pot
kidritalina: doesn't show hand 
*** SUMMARY ***
Total pot 1650 | Rake 0 
Board [Kd 4d Qd]
Seat 1: vishiwa folded before Flop (didn't bet)
Seat 2: Vinteseis36 folded before Flop (didn't bet)
Seat 3: frogz69 folded before Flop (didn't bet)
Seat 4: fmorandi (button) folded before Flop (didn't bet)
Seat 5: Caio Mugarte (small blind) folded on the Flop
Seat 6: kidritalina (big blind) collected (1650)
Seat 7: rebeLoNrun folded before Flop (didn't bet)
Seat 8: SOY PATO355 folded before Flop (didn't bet)
Seat 9: TheMagixFlop folded before Flop (didn't bet)



PokerStars Hand #245448235847: Tournament #3632677041, $0.23+$0.02 USD Hold'em No Limit - Level X (300/600) - 2023/08/17 19:05:44 AT [2023/08/17 18:05:44 ET]
Table '3632677041 4' 9-max Seat #5 is the button
Seat 1: vishiwa (8692 in chips) 
Seat 2: Vinteseis36 (5552 in chips) 
Seat 3: frogz69 (6303 in chips) 
Seat 4: fmorandi (8485 in chips) 
Seat 5: Caio Mugarte (6150 in chips) 
Seat 6: kidritalina (11629 in chips) 
Seat 7: rebeLoNrun (6891 in chips) 
Seat 8: SOY PATO355 (10492 in chips) 
Seat 9: TheMagixFlop (3306 in chips) 
vishiwa: posts the ante 50
Vinteseis36: posts the ante 50
frogz69: posts the ante 50
fmorandi: posts the ante 50
Caio Mugarte: posts the ante 50
kidritalina: posts the ante 50
rebeLoNrun: posts the ante 50
SOY PATO355: posts the ante 50
TheMagixFlop: posts the ante 50
kidritalina: posts small blind 300
rebeLoNrun: posts big blind 600
*** HOLE CARDS ***
Dealt to Caio Mugarte [Qc 3h]
SOY PATO355: folds 
TheMagixFlop: folds 
vishiwa: folds 
Vinteseis36: folds 
frogz69: folds 
fmorandi: raises 600 to 1200
Caio Mugarte: folds 
kidritalina: folds 
rebeLoNrun: folds 
Uncalled bet (600) returned to fmorandi
fmorandi collected 1950 from pot
*** SUMMARY ***
Total pot 1950 | Rake 0 
Seat 1: vishiwa folded before Flop (didn't bet)
Seat 2: Vinteseis36 folded before Flop (didn't bet)
Seat 3: frogz69 folded before Flop (didn't bet)
Seat 4: fmorandi collected (1950)
Seat 5: Caio Mugarte (button) folded before Flop (didn't bet)
Seat 6: kidritalina (small blind) folded before Flop
Seat 7: rebeLoNrun (big blind) folded before Flop
Seat 8: SOY PATO355 folded before Flop (didn't bet)
Seat 9: TheMagixFlop folded before Flop (didn't bet)



PokerStars Hand #245448239769: Tournament #3632677041, $0.23+$0.02 USD Hold'em No Limit - Level X (300/600) - 2023/08/17 19:05:56 AT [2023/08/17 18:05:56 ET]
Table '3632677041 4' 9-max Seat #6 is the button
Seat 1: vishiwa (8642 in chips) 
Seat 2: Vinteseis36 (5502 in chips) 
Seat 3: frogz69 (6253 in chips) 
Seat 4: fmorandi (9785 in chips) 
Seat 5: Caio Mugarte (6100 in chips) 
Seat 6: kidritalina (11279 in chips) 
Seat 7: rebeLoNrun (6241 in chips) 
Seat 8: SOY PATO355 (10442 in chips) 
Seat 9: TheMagixFlop (3256 in chips) 
vishiwa: posts the ante 50
Vinteseis36: posts the ante 50
frogz69: posts the ante 50
fmorandi: posts the ante 50
Caio Mugarte: posts the ante 50
kidritalina: posts the ante 50
rebeLoNrun: posts the ante 50
SOY PATO355: posts the ante 50
TheMagixFlop: posts the ante 50
rebeLoNrun: posts small blind 300
SOY PATO355: posts big blind 600
*** HOLE CARDS ***
Dealt to Caio Mugarte [7h 3c]
TheMagixFlop: folds 
vishiwa: raises 1200 to 1800
SOY PATO355 is disconnected 
Vinteseis36: folds 
frogz69: folds 
fmorandi: folds 
Caio Mugarte: folds 
kidritalina: folds 
rebeLoNrun: folds 
SOY PATO355 is disconnected 
SOY PATO355 is connected 
SOY PATO355: folds 
Uncalled bet (1200) returned to vishiwa
vishiwa collected 1950 from pot
vishiwa: doesn't show hand 
*** SUMMARY ***
Total pot 1950 | Rake 0 
Seat 1: vishiwa collected (1950)
Seat 2: Vinteseis36 folded before Flop (didn't bet)
Seat 3: frogz69 folded before Flop (didn't bet)
Seat 4: fmorandi folded before Flop (didn't bet)
Seat 5: Caio Mugarte folded before Flop (didn't bet)
Seat 6: kidritalina (button) folded before Flop (didn't bet)
Seat 7: rebeLoNrun (small blind) folded before Flop
Seat 8: SOY PATO355 (big blind) folded before Flop
Seat 9: TheMagixFlop folded before Flop (didn't bet)



PokerStars Hand #245448249529: Tournament #3632677041, $0.23+$0.02 USD Hold'em No Limit - Level X (300/600) - 2023/08/17 19:06:29 AT [2023/08/17 18:06:29 ET]
Table '3632677041 4' 9-max Seat #7 is the button
Seat 1: vishiwa (9942 in chips) 
Seat 2: Vinteseis36 (5452 in chips) 
Seat 3: frogz69 (6203 in chips) 
Seat 4: fmorandi (9735 in chips) 
Seat 5: Caio Mugarte (6050 in chips) 
Seat 6: kidritalina (11229 in chips) 
Seat 7: rebeLoNrun (5891 in chips) 
Seat 8: SOY PATO355 (9792 in chips) 
Seat 9: TheMagixFlop (3206 in chips) 
vishiwa: posts the ante 50
Vinteseis36: posts the ante 50
frogz69: posts the ante 50
fmorandi: posts the ante 50
Caio Mugarte: posts the ante 50
kidritalina: posts the ante 50
rebeLoNrun: posts the ante 50
SOY PATO355: posts the ante 50
TheMagixFlop: posts the ante 50
SOY PATO355: posts small blind 300
TheMagixFlop: posts big blind 600
*** HOLE CARDS ***
Dealt to Caio Mugarte [5h Kd]
vishiwa: folds 
Vinteseis36: folds 
frogz69: folds 
fmorandi: calls 600
Caio Mugarte: folds 
kidritalina: folds 
rebeLoNrun: folds 
SOY PATO355: calls 300
TheMagixFlop: checks 
*** FLOP *** [Ac Kc As]
SOY PATO355: checks 
TheMagixFlop: checks 
fmorandi: checks 
*** TURN *** [Ac Kc As] [4d]
SOY PATO355: checks 
TheMagixFlop: checks 
fmorandi: bets 600
SOY PATO355: folds 
TheMagixFlop: folds 
Uncalled bet (600) returned to fmorandi
fmorandi collected 2250 from pot
*** SUMMARY ***
Total pot 2250 | Rake 0 
Board [Ac Kc As 4d]
Seat 1: vishiwa folded before Flop (didn't bet)
Seat 2: Vinteseis36 folded before Flop (didn't bet)
Seat 3: frogz69 folded before Flop (didn't bet)
Seat 4: fmorandi collected (2250)
Seat 5: Caio Mugarte folded before Flop (didn't bet)
Seat 6: kidritalina folded before Flop (didn't bet)
Seat 7: rebeLoNrun (button) folded before Flop (didn't bet)
Seat 8: SOY PATO355 (small blind) folded on the Turn
Seat 9: TheMagixFlop (big blind) folded on the Turn



PokerStars Hand #245448263409: Tournament #3632677041, $0.23+$0.02 USD Hold'em No Limit - Level X (300/600) - 2023/08/17 19:07:15 AT [2023/08/17 18:07:15 ET]
Table '3632677041 4' 9-max Seat #8 is the button
Seat 1: vishiwa (9892 in chips) 
Seat 2: Vinteseis36 (5402 in chips) 
Seat 3: frogz69 (6153 in chips) 
Seat 4: fmorandi (11335 in chips) 
Seat 5: Caio Mugarte (6000 in chips) 
Seat 6: kidritalina (11179 in chips) 
Seat 7: rebeLoNrun (5841 in chips) 
Seat 8: SOY PATO355 (9142 in chips) 
Seat 9: TheMagixFlop (2556 in chips) 
vishiwa: posts the ante 50
Vinteseis36: posts the ante 50
frogz69: posts the ante 50
fmorandi: posts the ante 50
Caio Mugarte: posts the ante 50
kidritalina: posts the ante 50
rebeLoNrun: posts the ante 50
SOY PATO355: posts the ante 50
TheMagixFlop: posts the ante 50
TheMagixFlop: posts small blind 300
vishiwa: posts big blind 600
*** HOLE CARDS ***
Dealt to Caio Mugarte [4s Jd]
Vinteseis36: folds 
frogz69: calls 600
fmorandi: folds 
Caio Mugarte: folds 
kidritalina: folds 
rebeLoNrun: folds 
SOY PATO355: folds 
TheMagixFlop: folds 
vishiwa: checks 
*** FLOP *** [8c Qh 9c]
vishiwa: checks 
frogz69: checks 
*** TURN *** [8c Qh 9c] [7c]
vishiwa: checks 
frogz69: checks 
*** RIVER *** [8c Qh 9c 7c] [6s]
vishiwa: checks 
frogz69: checks 
*** SHOW DOWN ***
vishiwa: shows [6d As] (a pair of Sixes)
frogz69: mucks hand 
vishiwa collected 1950 from pot
*** SUMMARY ***
Total pot 1950 | Rake 0 
Board [8c Qh 9c 7c 6s]
Seat 1: vishiwa (big blind) showed [6d As] and won (1950) with a pair of Sixes
Seat 2: Vinteseis36 folded before Flop (didn't bet)
Seat 3: frogz69 mucked [Ah Kh]
Seat 4: fmorandi folded before Flop (didn't bet)
Seat 5: Caio Mugarte folded before Flop (didn't bet)
Seat 6: kidritalina folded before Flop (didn't bet)
Seat 7: rebeLoNrun folded before Flop (didn't bet)
Seat 8: SOY PATO355 (button) folded before Flop (didn't bet)
Seat 9: TheMagixFlop (small blind) folded before Flop



PokerStars Hand #245448276230: Tournament #3632677041, $0.23+$0.02 USD Hold'em No Limit - Level X (300/600) - 2023/08/17 19:07:58 AT [2023/08/17 18:07:58 ET]
Table '3632677041 4' 9-max Seat #9 is the button
Seat 1: vishiwa (11192 in chips) 
Seat 2: Vinteseis36 (5352 in chips) 
Seat 3: frogz69 (5503 in chips) 
Seat 4: fmorandi (11285 in chips) 
Seat 5: Caio Mugarte (5950 in chips) 
Seat 6: kidritalina (11129 in chips) 
Seat 7: rebeLoNrun (5791 in chips) 
Seat 8: SOY PATO355 (9092 in chips) 
Seat 9: TheMagixFlop (2206 in chips) 
vishiwa: posts the ante 50
Vinteseis36: posts the ante 50
frogz69: posts the ante 50
fmorandi: posts the ante 50
Caio Mugarte: posts the ante 50
kidritalina: posts the ante 50
rebeLoNrun: posts the ante 50
SOY PATO355: posts the ante 50
TheMagixFlop: posts the ante 50
vishiwa: posts small blind 300
Vinteseis36: posts big blind 600
*** HOLE CARDS ***
Dealt to Caio Mugarte [Kc 7s]
frogz69: folds 
fmorandi: raises 600 to 1200
Caio Mugarte: folds 
kidritalina: folds 
rebeLoNrun: folds 
SOY PATO355: folds 
TheMagixFlop: folds 
vishiwa: folds 
Vinteseis36: folds 
Uncalled bet (600) returned to fmorandi
fmorandi collected 1950 from pot
*** SUMMARY ***
Total pot 1950 | Rake 0 
Seat 1: vishiwa (small blind) folded before Flop
Seat 2: Vinteseis36 (big blind) folded before Flop
Seat 3: frogz69 folded before Flop (didn't bet)
Seat 4: fmorandi collected (1950)
Seat 5: Caio Mugarte folded before Flop (didn't bet)
Seat 6: kidritalina folded before Flop (didn't bet)
Seat 7: rebeLoNrun folded before Flop (didn't bet)
Seat 8: SOY PATO355 folded before Flop (didn't bet)
Seat 9: TheMagixFlop (button) folded before Flop (didn't bet)



PokerStars Hand #245448280832: Tournament #3632677041, $0.23+$0.02 USD Hold'em No Limit - Level X (300/600) - 2023/08/17 19:08:13 AT [2023/08/17 18:08:13 ET]
Table '3632677041 4' 9-max Seat #1 is the button
Seat 1: vishiwa (10842 in chips) 
Seat 2: Vinteseis36 (4702 in chips) 
Seat 3: frogz69 (5453 in chips) 
Seat 4: fmorandi (12585 in chips) 
Seat 5: Caio Mugarte (5900 in chips) 
Seat 6: kidritalina (11079 in chips) 
Seat 7: rebeLoNrun (5741 in chips) 
Seat 8: SOY PATO355 (9042 in chips) 
Seat 9: TheMagixFlop (2156 in chips) 
vishiwa: posts the ante 50
Vinteseis36: posts the ante 50
frogz69: posts the ante 50
fmorandi: posts the ante 50
Caio Mugarte: posts the ante 50
kidritalina: posts the ante 50
rebeLoNrun: posts the ante 50
SOY PATO355: posts the ante 50
TheMagixFlop: posts the ante 50
Vinteseis36: posts small blind 300
frogz69: posts big blind 600
*** HOLE CARDS ***
Dealt to Caio Mugarte [7h 9s]
fmorandi: calls 600
Caio Mugarte: folds 
kidritalina: folds 
rebeLoNrun: folds 
SOY PATO355: folds 
TheMagixFlop: folds 
vishiwa: raises 3000 to 3600
Vinteseis36: folds 
frogz69: folds 
fmorandi: calls 3000
*** FLOP *** [2h 5h As]
fmorandi: checks 
vishiwa: bets 1200
fmorandi: folds 
Uncalled bet (1200) returned to vishiwa
vishiwa collected 8550 from pot
vishiwa: doesn't show hand 
*** SUMMARY ***
Total pot 8550 | Rake 0 
Board [2h 5h As]
Seat 1: vishiwa (button) collected (8550)
Seat 2: Vinteseis36 (small blind) folded before Flop
Seat 3: frogz69 (big blind) folded before Flop
Seat 4: fmorandi folded on the Flop
Seat 5: Caio Mugarte folded before Flop (didn't bet)
Seat 6: kidritalina folded before Flop (didn't bet)
Seat 7: rebeLoNrun folded before Flop (didn't bet)
Seat 8: SOY PATO355 folded before Flop (didn't bet)
Seat 9: TheMagixFlop folded before Flop (didn't bet)



PokerStars Hand #245448292802: Tournament #3632677041, $0.23+$0.02 USD Hold'em No Limit - Level X (300/600) - 2023/08/17 19:08:54 AT [2023/08/17 18:08:54 ET]
Table '3632677041 4' 9-max Seat #2 is the button
Seat 1: vishiwa (15742 in chips) 
Seat 2: Vinteseis36 (4352 in chips) 
Seat 3: frogz69 (4803 in chips) 
Seat 4: fmorandi (8935 in chips) 
Seat 5: Caio Mugarte (5850 in chips) 
Seat 6: kidritalina (11029 in chips) 
Seat 7: rebeLoNrun (5691 in chips) 
Seat 8: SOY PATO355 (8992 in chips) 
Seat 9: TheMagixFlop (2106 in chips) 
vishiwa: posts the ante 50
Vinteseis36: posts the ante 50
frogz69: posts the ante 50
fmorandi: posts the ante 50
Caio Mugarte: posts the ante 50
kidritalina: posts the ante 50
rebeLoNrun: posts the ante 50
SOY PATO355: posts the ante 50
TheMagixFlop: posts the ante 50
frogz69: posts small blind 300
fmorandi: posts big blind 600
*** HOLE CARDS ***
Dealt to Caio Mugarte [Tc Qd]
Caio Mugarte: folds 
kidritalina: folds 
rebeLoNrun: folds 
SOY PATO355: folds 
TheMagixFlop: folds 
vishiwa: folds 
Vinteseis36: folds 
frogz69: calls 300
fmorandi: checks 
*** FLOP *** [7s 7d Jc]
frogz69: checks 
fmorandi: checks 
*** TURN *** [7s 7d Jc] [5h]
frogz69: bets 600
fmorandi: calls 600
*** RIVER *** [7s 7d Jc 5h] [4s]
frogz69: bets 3553 and is all-in
fmorandi: folds 
Uncalled bet (3553) returned to frogz69
frogz69 collected 2850 from pot
frogz69: doesn't show hand 
*** SUMMARY ***
Total pot 2850 | Rake 0 
Board [7s 7d Jc 5h 4s]
Seat 1: vishiwa folded before Flop (didn't bet)
Seat 2: Vinteseis36 (button) folded before Flop (didn't bet)
Seat 3: frogz69 (small blind) collected (2850)
Seat 4: fmorandi (big blind) folded on the River
Seat 5: Caio Mugarte folded before Flop (didn't bet)
Seat 6: kidritalina folded before Flop (didn't bet)
Seat 7: rebeLoNrun folded before Flop (didn't bet)
Seat 8: SOY PATO355 folded before Flop (didn't bet)
Seat 9: TheMagixFlop folded before Flop (didn't bet)



PokerStars Hand #245448306256: Tournament #3632677041, $0.23+$0.02 USD Hold'em No Limit - Level X (300/600) - 2023/08/17 19:09:39 AT [2023/08/17 18:09:39 ET]
Table '3632677041 4' 9-max Seat #3 is the button
Seat 1: vishiwa (15692 in chips) 
Seat 2: Vinteseis36 (4302 in chips) 
Seat 3: frogz69 (6403 in chips) 
Seat 4: fmorandi (7685 in chips) 
Seat 5: Caio Mugarte (5800 in chips) 
Seat 6: kidritalina (10979 in chips) 
Seat 7: rebeLoNrun (5641 in chips) 
Seat 8: SOY PATO355 (8942 in chips) 
Seat 9: TheMagixFlop (2056 in chips) 
vishiwa: posts the ante 50
Vinteseis36: posts the ante 50
frogz69: posts the ante 50
fmorandi: posts the ante 50
Caio Mugarte: posts the ante 50
kidritalina: posts the ante 50
rebeLoNrun: posts the ante 50
SOY PATO355: posts the ante 50
TheMagixFlop: posts the ante 50
fmorandi: posts small blind 300
Caio Mugarte: posts big blind 600
*** HOLE CARDS ***
Dealt to Caio Mugarte [Qc 6s]
kidritalina: folds 
rebeLoNrun: folds 
SOY PATO355: folds 
TheMagixFlop: folds 
vishiwa: folds 
Vinteseis36: folds 
frogz69: folds 
fmorandi: folds 
Uncalled bet (300) returned to Caio Mugarte
Caio Mugarte collected 1050 from pot
Caio Mugarte: doesn't show hand 
*** SUMMARY ***
Total pot 1050 | Rake 0 
Seat 1: vishiwa folded before Flop (didn't bet)
Seat 2: Vinteseis36 folded before Flop (didn't bet)
Seat 3: frogz69 (button) folded before Flop (didn't bet)
Seat 4: fmorandi (small blind) folded before Flop
Seat 5: Caio Mugarte (big blind) collected (1050)
Seat 6: kidritalina folded before Flop (didn't bet)
Seat 7: rebeLoNrun folded before Flop (didn't bet)
Seat 8: SOY PATO355 folded before Flop (didn't bet)
Seat 9: TheMagixFlop folded before Flop (didn't bet)



PokerStars Hand #245448311958: Tournament #3632677041, $0.23+$0.02 USD Hold'em No Limit - Level X (300/600) - 2023/08/17 19:09:58 AT [2023/08/17 18:09:58 ET]
Table '3632677041 4' 9-max Seat #4 is the button
Seat 1: vishiwa (15642 in chips) 
Seat 2: Vinteseis36 (4252 in chips) 
Seat 3: frogz69 (6353 in chips) 
Seat 4: fmorandi (7335 in chips) 
Seat 5: Caio Mugarte (6500 in chips) 
Seat 6: kidritalina (10929 in chips) 
Seat 7: rebeLoNrun (5591 in chips) 
Seat 8: SOY PATO355 (8892 in chips) 
Seat 9: TheMagixFlop (2006 in chips) 
vishiwa: posts the ante 50
Vinteseis36: posts the ante 50
frogz69: posts the ante 50
fmorandi: posts the ante 50
Caio Mugarte: posts the ante 50
kidritalina: posts the ante 50
rebeLoNrun: posts the ante 50
SOY PATO355: posts the ante 50
TheMagixFlop: posts the ante 50
Caio Mugarte: posts small blind 300
kidritalina: posts big blind 600
*** HOLE CARDS ***
Dealt to Caio Mugarte [3d Js]
rebeLoNrun: folds 
SOY PATO355: folds 
TheMagixFlop: folds 
vishiwa: folds 
Vinteseis36: folds 
frogz69: raises 5703 to 6303 and is all-in
fmorandi: folds 
Caio Mugarte: folds 
kidritalina: folds 
Uncalled bet (5703) returned to frogz69
frogz69 collected 1950 from pot
frogz69: doesn't show hand 
*** SUMMARY ***
Total pot 1950 | Rake 0 
Seat 1: vishiwa folded before Flop (didn't bet)
Seat 2: Vinteseis36 folded before Flop (didn't bet)
Seat 3: frogz69 collected (1950)
Seat 4: fmorandi (button) folded before Flop (didn't bet)
Seat 5: Caio Mugarte (small blind) folded before Flop
Seat 6: kidritalina (big blind) folded before Flop
Seat 7: rebeLoNrun folded before Flop (didn't bet)
Seat 8: SOY PATO355 folded before Flop (didn't bet)
Seat 9: TheMagixFlop folded before Flop (didn't bet)



PokerStars Hand #245448319971: Tournament #3632677041, $0.23+$0.02 USD Hold'em No Limit - Level X (300/600) - 2023/08/17 19:10:26 AT [2023/08/17 18:10:26 ET]
Table '3632677041 4' 9-max Seat #5 is the button
Seat 1: vishiwa (15592 in chips) 
Seat 2: Vinteseis36 (4202 in chips) 
Seat 3: frogz69 (7653 in chips) 
Seat 4: fmorandi (7285 in chips) 
Seat 5: Caio Mugarte (6150 in chips) 
Seat 6: kidritalina (10279 in chips) 
Seat 7: rebeLoNrun (5541 in chips) 
Seat 8: SOY PATO355 (8842 in chips) 
Seat 9: TheMagixFlop (1956 in chips) 
vishiwa: posts the ante 50
Vinteseis36: posts the ante 50
frogz69: posts the ante 50
fmorandi: posts the ante 50
Caio Mugarte: posts the ante 50
kidritalina: posts the ante 50
rebeLoNrun: posts the ante 50
SOY PATO355: posts the ante 50
TheMagixFlop: posts the ante 50
kidritalina: posts small blind 300
rebeLoNrun: posts big blind 600
*** HOLE CARDS ***
Dealt to Caio Mugarte [5c 4h]
SOY PATO355: folds 
TheMagixFlop: raises 1306 to 1906 and is all-in
vishiwa: calls 1906
Vinteseis36: folds 
frogz69: folds 
fmorandi: folds 
Caio Mugarte: folds 
kidritalina: folds 
rebeLoNrun: folds 
*** FLOP *** [7c 3c Jd]
*** TURN *** [7c 3c Jd] [7h]
*** RIVER *** [7c 3c Jd 7h] [8s]
*** SHOW DOWN ***
TheMagixFlop: shows [Js Kh] (two pair, Jacks and Sevens)
vishiwa: shows [Ac Ks] (a pair of Sevens)
TheMagixFlop collected 5162 from pot
*** SUMMARY ***
Total pot 5162 | Rake 0 
Board [7c 3c Jd 7h 8s]
Seat 1: vishiwa showed [Ac Ks] and lost with a pair of Sevens
Seat 2: Vinteseis36 folded before Flop (didn't bet)
Seat 3: frogz69 folded before Flop (didn't bet)
Seat 4: fmorandi folded before Flop (didn't bet)
Seat 5: Caio Mugarte (button) folded before Flop (didn't bet)
Seat 6: kidritalina (small blind) folded before Flop
Seat 7: rebeLoNrun (big blind) folded before Flop
Seat 8: SOY PATO355 folded before Flop (didn't bet)
Seat 9: TheMagixFlop showed [Js Kh] and won (5162) with two pair, Jacks and Sevens



PokerStars Hand #245448328323: Tournament #3632677041, $0.23+$0.02 USD Hold'em No Limit - Level X (300/600) - 2023/08/17 19:10:54 AT [2023/08/17 18:10:54 ET]
Table '3632677041 4' 9-max Seat #6 is the button
Seat 1: vishiwa (13636 in chips) 
Seat 2: Vinteseis36 (4152 in chips) 
Seat 3: frogz69 (7603 in chips) 
Seat 4: fmorandi (7235 in chips) 
Seat 5: Caio Mugarte (6100 in chips) 
Seat 6: kidritalina (9929 in chips) 
Seat 7: rebeLoNrun (4891 in chips) 
Seat 8: SOY PATO355 (8792 in chips) 
Seat 9: TheMagixFlop (5162 in chips) 
vishiwa: posts the ante 50
Vinteseis36: posts the ante 50
frogz69: posts the ante 50
fmorandi: posts the ante 50
Caio Mugarte: posts the ante 50
kidritalina: posts the ante 50
rebeLoNrun: posts the ante 50
SOY PATO355: posts the ante 50
TheMagixFlop: posts the ante 50
rebeLoNrun: posts small blind 300
SOY PATO355: posts big blind 600
*** HOLE CARDS ***
Dealt to Caio Mugarte [9c 8s]
TheMagixFlop: folds 
vishiwa: folds 
Vinteseis36: folds 
frogz69: folds 
fmorandi: folds 
Caio Mugarte: folds 
kidritalina: raises 1200 to 1800
rebeLoNrun: folds 
SOY PATO355: folds 
Uncalled bet (1200) returned to kidritalina
kidritalina collected 1950 from pot
kidritalina: doesn't show hand 
*** SUMMARY ***
Total pot 1950 | Rake 0 
Seat 1: vishiwa folded before Flop (didn't bet)
Seat 2: Vinteseis36 folded before Flop (didn't bet)
Seat 3: frogz69 folded before Flop (didn't bet)
Seat 4: fmorandi folded before Flop (didn't bet)
Seat 5: Caio Mugarte folded before Flop (didn't bet)
Seat 6: kidritalina (button) collected (1950)
Seat 7: rebeLoNrun (small blind) folded before Flop
Seat 8: SOY PATO355 (big blind) folded before Flop
Seat 9: TheMagixFlop folded before Flop (didn't bet)



PokerStars Hand #245448334211: Tournament #3632677041, $0.23+$0.02 USD Hold'em No Limit - Level X (300/600) - 2023/08/17 19:11:14 AT [2023/08/17 18:11:14 ET]
Table '3632677041 4' 9-max Seat #7 is the button
Seat 1: vishiwa (13586 in chips) 
Seat 2: Vinteseis36 (4102 in chips) 
Seat 3: frogz69 (7553 in chips) 
Seat 4: fmorandi (7185 in chips) 
Seat 5: Caio Mugarte (6050 in chips) 
Seat 6: kidritalina (11229 in chips) 
Seat 7: rebeLoNrun (4541 in chips) 
Seat 8: SOY PATO355 (8142 in chips) 
Seat 9: TheMagixFlop (5112 in chips) 
vishiwa: posts the ante 50
Vinteseis36: posts the ante 50
frogz69: posts the ante 50
fmorandi: posts the ante 50
Caio Mugarte: posts the ante 50
kidritalina: posts the ante 50
rebeLoNrun: posts the ante 50
SOY PATO355: posts the ante 50
TheMagixFlop: posts the ante 50
SOY PATO355: posts small blind 300
TheMagixFlop: posts big blind 600
*** HOLE CARDS ***
Dealt to Caio Mugarte [9h Kh]
vishiwa: calls 600
Vinteseis36: folds 
frogz69: folds 
fmorandi: folds 
Caio Mugarte: folds 
kidritalina: folds 
rebeLoNrun: folds 
SOY PATO355: calls 300
TheMagixFlop: checks 
*** FLOP *** [6d 5c Qs]
SOY PATO355: checks 
TheMagixFlop: checks 
vishiwa: bets 600
SOY PATO355: folds 
TheMagixFlop: folds 
Uncalled bet (600) returned to vishiwa
vishiwa collected 2250 from pot
vishiwa: doesn't show hand 
*** SUMMARY ***
Total pot 2250 | Rake 0 
Board [6d 5c Qs]
Seat 1: vishiwa collected (2250)
Seat 2: Vinteseis36 folded before Flop (didn't bet)
Seat 3: frogz69 folded before Flop (didn't bet)
Seat 4: fmorandi folded before Flop (didn't bet)
Seat 5: Caio Mugarte folded before Flop (didn't bet)
Seat 6: kidritalina folded before Flop (didn't bet)
Seat 7: rebeLoNrun (button) folded before Flop (didn't bet)
Seat 8: SOY PATO355 (small blind) folded on the Flop
Seat 9: TheMagixFlop (big blind) folded on the Flop



PokerStars Hand #245448347173: Tournament #3632677041, $0.23+$0.02 USD Hold'em No Limit - Level X (300/600) - 2023/08/17 19:11:58 AT [2023/08/17 18:11:58 ET]
Table '3632677041 4' 9-max Seat #8 is the button
Seat 1: vishiwa (15186 in chips) 
Seat 2: Vinteseis36 (4052 in chips) 
Seat 3: frogz69 (7503 in chips) 
Seat 4: fmorandi (7135 in chips) 
Seat 5: Caio Mugarte (6000 in chips) 
Seat 6: kidritalina (11179 in chips) 
Seat 7: rebeLoNrun (4491 in chips) 
Seat 8: SOY PATO355 (7492 in chips) 
Seat 9: TheMagixFlop (4462 in chips) 
vishiwa: posts the ante 50
Vinteseis36: posts the ante 50
frogz69: posts the ante 50
fmorandi: posts the ante 50
Caio Mugarte: posts the ante 50
kidritalina: posts the ante 50
rebeLoNrun: posts the ante 50
SOY PATO355: posts the ante 50
TheMagixFlop: posts the ante 50
TheMagixFlop: posts small blind 300
vishiwa: posts big blind 600
*** HOLE CARDS ***
Dealt to Caio Mugarte [Ks Jc]
Vinteseis36: folds 
frogz69: folds 
fmorandi: raises 600 to 1200
Caio Mugarte: folds 
kidritalina: folds 
rebeLoNrun: folds 
SOY PATO355: folds 
TheMagixFlop: folds 
vishiwa: calls 600
*** FLOP *** [Qh 8c 2h]
vishiwa: checks 
fmorandi: bets 1200
vishiwa: calls 1200
*** TURN *** [Qh 8c 2h] [8s]
vishiwa: checks 
fmorandi: checks 
*** RIVER *** [Qh 8c 2h 8s] [4h]
vishiwa: bets 1800
fmorandi: folds 
Uncalled bet (1800) returned to vishiwa
vishiwa collected 5550 from pot
vishiwa: doesn't show hand 
*** SUMMARY ***
Total pot 5550 | Rake 0 
Board [Qh 8c 2h 8s 4h]
Seat 1: vishiwa (big blind) collected (5550)
Seat 2: Vinteseis36 folded before Flop (didn't bet)
Seat 3: frogz69 folded before Flop (didn't bet)
Seat 4: fmorandi folded on the River
Seat 5: Caio Mugarte folded before Flop (didn't bet)
Seat 6: kidritalina folded before Flop (didn't bet)
Seat 7: rebeLoNrun folded before Flop (didn't bet)
Seat 8: SOY PATO355 (button) folded before Flop (didn't bet)
Seat 9: TheMagixFlop (small blind) folded before Flop



PokerStars Hand #245448363937: Tournament #3632677041, $0.23+$0.02 USD Hold'em No Limit - Level X (300/600) - 2023/08/17 19:12:55 AT [2023/08/17 18:12:55 ET]
Table '3632677041 4' 9-max Seat #9 is the button
Seat 1: vishiwa (18286 in chips) 
Seat 2: Vinteseis36 (4002 in chips) 
Seat 3: frogz69 (7453 in chips) 
Seat 4: fmorandi (4685 in chips) 
Seat 5: Caio Mugarte (5950 in chips) 
Seat 6: kidritalina (11129 in chips) 
Seat 7: rebeLoNrun (4441 in chips) 
Seat 8: SOY PATO355 (7442 in chips) 
Seat 9: TheMagixFlop (4112 in chips) 
vishiwa: posts the ante 50
Vinteseis36: posts the ante 50
frogz69: posts the ante 50
fmorandi: posts the ante 50
Caio Mugarte: posts the ante 50
kidritalina: posts the ante 50
rebeLoNrun: posts the ante 50
SOY PATO355: posts the ante 50
TheMagixFlop: posts the ante 50
vishiwa: posts small blind 300
Vinteseis36: posts big blind 600
*** HOLE CARDS ***
Dealt to Caio Mugarte [3d 2d]
frogz69: folds 
fmorandi: folds 
Caio Mugarte: folds 
kidritalina: folds 
rebeLoNrun: raises 3791 to 4391 and is all-in
SOY PATO355: folds 
TheMagixFlop: folds 
vishiwa: folds 
Vinteseis36: folds 
Uncalled bet (3791) returned to rebeLoNrun
rebeLoNrun collected 1950 from pot
*** SUMMARY ***
Total pot 1950 | Rake 0 
Seat 1: vishiwa (small blind) folded before Flop
Seat 2: Vinteseis36 (big blind) folded before Flop
Seat 3: frogz69 folded before Flop (didn't bet)
Seat 4: fmorandi folded before Flop (didn't bet)
Seat 5: Caio Mugarte folded before Flop (didn't bet)
Seat 6: kidritalina folded before Flop (didn't bet)
Seat 7: rebeLoNrun collected (1950)
Seat 8: SOY PATO355 folded before Flop (didn't bet)
Seat 9: TheMagixFlop (button) folded before Flop (didn't bet)



PokerStars Hand #245448371384: Tournament #3632677041, $0.23+$0.02 USD Hold'em No Limit - Level X (300/600) - 2023/08/17 19:13:20 AT [2023/08/17 18:13:20 ET]
Table '3632677041 4' 9-max Seat #1 is the button
Seat 1: vishiwa (17936 in chips) 
Seat 2: Vinteseis36 (3352 in chips) 
Seat 3: frogz69 (7403 in chips) 
Seat 4: fmorandi (4635 in chips) 
Seat 5: Caio Mugarte (5900 in chips) 
Seat 6: kidritalina (11079 in chips) 
Seat 7: rebeLoNrun (5741 in chips) 
Seat 8: SOY PATO355 (7392 in chips) 
Seat 9: TheMagixFlop (4062 in chips) 
vishiwa: posts the ante 50
Vinteseis36: posts the ante 50
frogz69: posts the ante 50
fmorandi: posts the ante 50
Caio Mugarte: posts the ante 50
kidritalina: posts the ante 50
rebeLoNrun: posts the ante 50
SOY PATO355: posts the ante 50
TheMagixFlop: posts the ante 50
Vinteseis36: posts small blind 300
frogz69: posts big blind 600
*** HOLE CARDS ***
Dealt to Caio Mugarte [Ac Kd]
fmorandi: folds 
Caio Mugarte: raises 5250 to 5850 and is all-in
kidritalina: folds 
rebeLoNrun: folds 
SOY PATO355: folds 
TheMagixFlop: folds 
vishiwa: folds 
Vinteseis36: folds 
frogz69: folds 
Uncalled bet (5250) returned to Caio Mugarte
Caio Mugarte collected 1950 from pot
Caio Mugarte: doesn't show hand 
*** SUMMARY ***
Total pot 1950 | Rake 0 
Seat 1: vishiwa (button) folded before Flop (didn't bet)
Seat 2: Vinteseis36 (small blind) folded before Flop
Seat 3: frogz69 (big blind) folded before Flop
Seat 4: fmorandi folded before Flop (didn't bet)
Seat 5: Caio Mugarte collected (1950)
Seat 6: kidritalina folded before Flop (didn't bet)
Seat 7: rebeLoNrun folded before Flop (didn't bet)
Seat 8: SOY PATO355 folded before Flop (didn't bet)
Seat 9: TheMagixFlop folded before Flop (didn't bet)



PokerStars Hand #245448378257: Tournament #3632677041, $0.23+$0.02 USD Hold'em No Limit - Level X (300/600) - 2023/08/17 19:13:44 AT [2023/08/17 18:13:44 ET]
Table '3632677041 4' 9-max Seat #2 is the button
Seat 1: vishiwa (17886 in chips) 
Seat 2: Vinteseis36 (3002 in chips) 
Seat 3: frogz69 (6753 in chips) 
Seat 4: fmorandi (4585 in chips) 
Seat 5: Caio Mugarte (7200 in chips) 
Seat 6: kidritalina (11029 in chips) 
Seat 7: rebeLoNrun (5691 in chips) 
Seat 8: SOY PATO355 (7342 in chips) 
Seat 9: TheMagixFlop (4012 in chips) 
vishiwa: posts the ante 50
Vinteseis36: posts the ante 50
frogz69: posts the ante 50
fmorandi: posts the ante 50
Caio Mugarte: posts the ante 50
kidritalina: posts the ante 50
rebeLoNrun: posts the ante 50
SOY PATO355: posts the ante 50
TheMagixFlop: posts the ante 50
frogz69: posts small blind 300
fmorandi: posts big blind 600
*** HOLE CARDS ***
Dealt to Caio Mugarte [3h Ah]
Caio Mugarte: folds 
kidritalina: folds 
rebeLoNrun: folds 
SOY PATO355: folds 
TheMagixFlop: folds 
vishiwa: folds 
Vinteseis36: folds 
frogz69: calls 300
fmorandi: checks 
*** FLOP *** [Kd Ac 8h]
frogz69: checks 
fmorandi: checks 
*** TURN *** [Kd Ac 8h] [Qs]
frogz69: bets 1089
fmorandi: folds 
Uncalled bet (1089) returned to frogz69
frogz69 collected 1650 from pot
frogz69: doesn't show hand 
*** SUMMARY ***
Total pot 1650 | Rake 0 
Board [Kd Ac 8h Qs]
Seat 1: vishiwa folded before Flop (didn't bet)
Seat 2: Vinteseis36 (button) folded before Flop (didn't bet)
Seat 3: frogz69 (small blind) collected (1650)
Seat 4: fmorandi (big blind) folded on the Turn
Seat 5: Caio Mugarte folded before Flop (didn't bet)
Seat 6: kidritalina folded before Flop (didn't bet)
Seat 7: rebeLoNrun folded before Flop (didn't bet)
Seat 8: SOY PATO355 folded before Flop (didn't bet)
Seat 9: TheMagixFlop folded before Flop (didn't bet)



PokerStars Hand #245448391168: Tournament #3632677041, $0.23+$0.02 USD Hold'em No Limit - Level X (300/600) - 2023/08/17 19:14:27 AT [2023/08/17 18:14:27 ET]
Table '3632677041 4' 9-max Seat #3 is the button
Seat 1: vishiwa (17836 in chips) 
Seat 2: Vinteseis36 (2952 in chips) 
Seat 3: frogz69 (7753 in chips) 
Seat 4: fmorandi (3935 in chips) 
Seat 5: Caio Mugarte (7150 in chips) 
Seat 6: kidritalina (10979 in chips) 
Seat 7: rebeLoNrun (5641 in chips) 
Seat 8: SOY PATO355 (7292 in chips) 
Seat 9: TheMagixFlop (3962 in chips) 
vishiwa: posts the ante 50
Vinteseis36: posts the ante 50
frogz69: posts the ante 50
fmorandi: posts the ante 50
Caio Mugarte: posts the ante 50
kidritalina: posts the ante 50
rebeLoNrun: posts the ante 50
SOY PATO355: posts the ante 50
TheMagixFlop: posts the ante 50
fmorandi: posts small blind 300
Caio Mugarte: posts big blind 600
*** HOLE CARDS ***
Dealt to Caio Mugarte [2s 7d]
kidritalina: raises 10329 to 10929 and is all-in
rebeLoNrun: folds 
SOY PATO355: folds 
TheMagixFlop: folds 
vishiwa: folds 
Vinteseis36: folds 
frogz69: folds 
fmorandi: folds 
Caio Mugarte: folds 
Uncalled bet (10329) returned to kidritalina
kidritalina collected 1950 from pot
kidritalina: doesn't show hand 
*** SUMMARY ***
Total pot 1950 | Rake 0 
Seat 1: vishiwa folded before Flop (didn't bet)
Seat 2: Vinteseis36 folded before Flop (didn't bet)
Seat 3: frogz69 (button) folded before Flop (didn't bet)
Seat 4: fmorandi (small blind) folded before Flop
Seat 5: Caio Mugarte (big blind) folded before Flop
Seat 6: kidritalina collected (1950)
Seat 7: rebeLoNrun folded before Flop (didn't bet)
Seat 8: SOY PATO355 folded before Flop (didn't bet)
Seat 9: TheMagixFlop folded before Flop (didn't bet)



PokerStars Hand #245448396633: Tournament #3632677041, $0.23+$0.02 USD Hold'em No Limit - Level X (300/600) - 2023/08/17 19:14:47 AT [2023/08/17 18:14:47 ET]
Table '3632677041 4' 9-max Seat #4 is the button
Seat 1: vishiwa (17786 in chips) 
Seat 2: Vinteseis36 (2902 in chips) 
Seat 3: frogz69 (7703 in chips) 
Seat 4: fmorandi (3585 in chips) 
Seat 5: Caio Mugarte (6500 in chips) 
Seat 6: kidritalina (12279 in chips) 
Seat 7: rebeLoNrun (5591 in chips) 
Seat 8: SOY PATO355 (7242 in chips) 
Seat 9: TheMagixFlop (3912 in chips) 
vishiwa: posts the ante 50
Vinteseis36: posts the ante 50
frogz69: posts the ante 50
fmorandi: posts the ante 50
Caio Mugarte: posts the ante 50
kidritalina: posts the ante 50
rebeLoNrun: posts the ante 50
SOY PATO355: posts the ante 50
TheMagixFlop: posts the ante 50
Caio Mugarte: posts small blind 300
kidritalina: posts big blind 600
*** HOLE CARDS ***
Dealt to Caio Mugarte [8c Ts]
rebeLoNrun: folds 
SOY PATO355: folds 
TheMagixFlop: folds 
vishiwa: folds 
Vinteseis36: folds 
frogz69: folds 
fmorandi: calls 600
Caio Mugarte: folds 
kidritalina: checks 
*** FLOP *** [Kd 5c 3s]
kidritalina: checks 
fmorandi: bets 600
kidritalina: folds 
Uncalled bet (600) returned to fmorandi
fmorandi collected 1950 from pot
*** SUMMARY ***
Total pot 1950 | Rake 0 
Board [Kd 5c 3s]
Seat 1: vishiwa folded before Flop (didn't bet)
Seat 2: Vinteseis36 folded before Flop (didn't bet)
Seat 3: frogz69 folded before Flop (didn't bet)
Seat 4: fmorandi (button) collected (1950)
Seat 5: Caio Mugarte (small blind) folded before Flop
Seat 6: kidritalina (big blind) folded on the Flop
Seat 7: rebeLoNrun folded before Flop (didn't bet)
Seat 8: SOY PATO355 folded before Flop (didn't bet)
Seat 9: TheMagixFlop folded before Flop (didn't bet)



PokerStars Hand #245448408686: Tournament #3632677041, $0.23+$0.02 USD Hold'em No Limit - Level XI (400/800) - 2023/08/17 19:15:28 AT [2023/08/17 18:15:28 ET]
Table '3632677041 4' 9-max Seat #5 is the button
Seat 1: vishiwa (17736 in chips) 
Seat 2: Vinteseis36 (2852 in chips) 
Seat 3: frogz69 (7653 in chips) 
Seat 4: fmorandi (4885 in chips) 
Seat 5: Caio Mugarte (6150 in chips) 
Seat 6: kidritalina (11629 in chips) 
Seat 7: rebeLoNrun (5541 in chips) 
Seat 8: SOY PATO355 (7192 in chips) 
Seat 9: TheMagixFlop (3862 in chips) 
vishiwa: posts the ante 50
Vinteseis36: posts the ante 50
frogz69: posts the ante 50
fmorandi: posts the ante 50
Caio Mugarte: posts the ante 50
kidritalina: posts the ante 50
rebeLoNrun: posts the ante 50
SOY PATO355: posts the ante 50
TheMagixFlop: posts the ante 50
kidritalina: posts small blind 400
rebeLoNrun: posts big blind 800
*** HOLE CARDS ***
Dealt to Caio Mugarte [Ad Kc]
SOY PATO355: folds 
TheMagixFlop: folds 
vishiwa: folds 
Vinteseis36: raises 800 to 1600
frogz69: folds 
fmorandi: folds 
Caio Mugarte: raises 4500 to 6100 and is all-in
kidritalina: folds 
rebeLoNrun: folds 
Vinteseis36: calls 1202 and is all-in
Uncalled bet (3298) returned to Caio Mugarte
*** FLOP *** [Qd Ts 2s]
*** TURN *** [Qd Ts 2s] [5s]
*** RIVER *** [Qd Ts 2s 5s] [4c]
*** SHOW DOWN ***
Vinteseis36: shows [Kd Kh] (a pair of Kings)
Caio Mugarte: shows [Ad Kc] (high card Ace)
Vinteseis36 collected 7254 from pot
*** SUMMARY ***
Total pot 7254 | Rake 0 
Board [Qd Ts 2s 5s 4c]
Seat 1: vishiwa folded before Flop (didn't bet)
Seat 2: Vinteseis36 showed [Kd Kh] and won (7254) with a pair of Kings
Seat 3: frogz69 folded before Flop (didn't bet)
Seat 4: fmorandi folded before Flop (didn't bet)
Seat 5: Caio Mugarte (button) showed [Ad Kc] and lost with high card Ace
Seat 6: kidritalina (small blind) folded before Flop
Seat 7: rebeLoNrun (big blind) folded before Flop
Seat 8: SOY PATO355 folded before Flop (didn't bet)
Seat 9: TheMagixFlop folded before Flop (didn't bet)



PokerStars Hand #245448419716: Tournament #3632677041, $0.23+$0.02 USD Hold'em No Limit - Level XI (400/800) - 2023/08/17 19:16:06 AT [2023/08/17 18:16:06 ET]
Table '3632677041 4' 9-max Seat #6 is the button
Seat 1: vishiwa (17686 in chips) 
Seat 2: Vinteseis36 (7254 in chips) 
Seat 3: frogz69 (7603 in chips) 
Seat 4: fmorandi (4835 in chips) 
Seat 5: Caio Mugarte (3298 in chips) 
Seat 6: kidritalina (11179 in chips) 
Seat 7: rebeLoNrun (4691 in chips) 
Seat 8: SOY PATO355 (7142 in chips) 
Seat 9: TheMagixFlop (3812 in chips) 
vishiwa: posts the ante 50
Vinteseis36: posts the ante 50
frogz69: posts the ante 50
fmorandi: posts the ante 50
Caio Mugarte: posts the ante 50
kidritalina: posts the ante 50
rebeLoNrun: posts the ante 50
SOY PATO355: posts the ante 50
TheMagixFlop: posts the ante 50
rebeLoNrun: posts small blind 400
SOY PATO355: posts big blind 800
*** HOLE CARDS ***
Dealt to Caio Mugarte [3c Tc]
TheMagixFlop: folds 
vishiwa: calls 800
Vinteseis36: folds 
frogz69: folds 
fmorandi: folds 
Caio Mugarte: folds 
kidritalina: folds 
rebeLoNrun: folds 
SOY PATO355: checks 
*** FLOP *** [4d 2h 4s]
SOY PATO355: checks 
vishiwa: checks 
*** TURN *** [4d 2h 4s] [3s]
SOY PATO355: checks 
vishiwa: checks 
*** RIVER *** [4d 2h 4s 3s] [Jd]
SOY PATO355: bets 800
vishiwa: calls 800
*** SHOW DOWN ***
SOY PATO355: shows [5d Ac] (a straight, Ace to Five)
vishiwa: mucks hand 
SOY PATO355 collected 4050 from pot
*** SUMMARY ***
Total pot 4050 | Rake 0 
Board [4d 2h 4s 3s Jd]
Seat 1: vishiwa mucked [Kh Jh]
Seat 2: Vinteseis36 folded before Flop (didn't bet)
Seat 3: frogz69 folded before Flop (didn't bet)
Seat 4: fmorandi folded before Flop (didn't bet)
Seat 5: Caio Mugarte folded before Flop (didn't bet)
Seat 6: kidritalina (button) folded before Flop (didn't bet)
Seat 7: rebeLoNrun (small blind) folded before Flop
Seat 8: SOY PATO355 (big blind) showed [5d Ac] and won (4050) with a straight, Ace to Five
Seat 9: TheMagixFlop folded before Flop (didn't bet)



PokerStars Hand #245448431372: Tournament #3632677041, $0.23+$0.02 USD Hold'em No Limit - Level XI (400/800) - 2023/08/17 19:16:45 AT [2023/08/17 18:16:45 ET]
Table '3632677041 4' 9-max Seat #7 is the button
Seat 1: vishiwa (16036 in chips) 
Seat 2: Vinteseis36 (7204 in chips) 
Seat 3: frogz69 (7553 in chips) 
Seat 4: fmorandi (4785 in chips) 
Seat 5: Caio Mugarte (3248 in chips) 
Seat 6: kidritalina (11129 in chips) 
Seat 7: rebeLoNrun (4241 in chips) 
Seat 8: SOY PATO355 (9542 in chips) 
Seat 9: TheMagixFlop (3762 in chips) 
vishiwa: posts the ante 50
Vinteseis36: posts the ante 50
frogz69: posts the ante 50
fmorandi: posts the ante 50
Caio Mugarte: posts the ante 50
kidritalina: posts the ante 50
rebeLoNrun: posts the ante 50
SOY PATO355: posts the ante 50
TheMagixFlop: posts the ante 50
SOY PATO355: posts small blind 400
TheMagixFlop: posts big blind 800
*** HOLE CARDS ***
Dealt to Caio Mugarte [3c 2c]
vishiwa: folds 
Vinteseis36: folds 
frogz69: folds 
fmorandi: folds 
Caio Mugarte: folds 
kidritalina: folds 
rebeLoNrun: folds 
SOY PATO355: folds 
Uncalled bet (400) returned to TheMagixFlop
TheMagixFlop collected 1250 from pot
*** SUMMARY ***
Total pot 1250 | Rake 0 
Seat 1: vishiwa folded before Flop (didn't bet)
Seat 2: Vinteseis36 folded before Flop (didn't bet)
Seat 3: frogz69 folded before Flop (didn't bet)
Seat 4: fmorandi folded before Flop (didn't bet)
Seat 5: Caio Mugarte folded before Flop (didn't bet)
Seat 6: kidritalina folded before Flop (didn't bet)
Seat 7: rebeLoNrun (button) folded before Flop (didn't bet)
Seat 8: SOY PATO355 (small blind) folded before Flop
Seat 9: TheMagixFlop (big blind) collected (1250)



PokerStars Hand #245448440764: Tournament #3632677041, $0.23+$0.02 USD Hold'em No Limit - Level XI (400/800) - 2023/08/17 19:17:17 AT [2023/08/17 18:17:17 ET]
Table '3632677041 4' 9-max Seat #8 is the button
Seat 1: vishiwa (15986 in chips) 
Seat 2: Vinteseis36 (7154 in chips) 
Seat 3: frogz69 (7503 in chips) 
Seat 4: fmorandi (4735 in chips) 
Seat 5: Caio Mugarte (3198 in chips) 
Seat 6: kidritalina (11079 in chips) 
Seat 7: rebeLoNrun (4191 in chips) 
Seat 8: SOY PATO355 (9092 in chips) 
Seat 9: TheMagixFlop (4562 in chips) 
vishiwa: posts the ante 50
Vinteseis36: posts the ante 50
frogz69: posts the ante 50
fmorandi: posts the ante 50
Caio Mugarte: posts the ante 50
kidritalina: posts the ante 50
rebeLoNrun: posts the ante 50
SOY PATO355: posts the ante 50
TheMagixFlop: posts the ante 50
TheMagixFlop: posts small blind 400
vishiwa: posts big blind 800
*** HOLE CARDS ***
Dealt to Caio Mugarte [8s 5s]
Vinteseis36: folds 
frogz69: folds 
fmorandi: calls 800
Caio Mugarte: folds 
kidritalina: folds 
rebeLoNrun: folds 
SOY PATO355: folds 
TheMagixFlop: folds 
vishiwa: checks 
*** FLOP *** [Th Tc 7d]
vishiwa: checks 
fmorandi: checks 
*** TURN *** [Th Tc 7d] [2s]
vishiwa: checks 
fmorandi: checks 
*** RIVER *** [Th Tc 7d 2s] [5h]
vishiwa: checks 
fmorandi: bets 800
vishiwa: calls 800
*** SHOW DOWN ***
fmorandi: shows [8c Kd] (a pair of Tens)
vishiwa: shows [8h Kc] (a pair of Tens)
vishiwa collected 2025 from pot
fmorandi collected 2025 from pot
*** SUMMARY ***
Total pot 4050 | Rake 0 
Board [Th Tc 7d 2s 5h]
Seat 1: vishiwa (big blind) showed [8h Kc] and won (2025) with a pair of Tens
Seat 2: Vinteseis36 folded before Flop (didn't bet)
Seat 3: frogz69 folded before Flop (didn't bet)
Seat 4: fmorandi showed [8c Kd] and won (2025) with a pair of Tens
Seat 5: Caio Mugarte folded before Flop (didn't bet)
Seat 6: kidritalina folded before Flop (didn't bet)
Seat 7: rebeLoNrun folded before Flop (didn't bet)
Seat 8: SOY PATO355 (button) folded before Flop (didn't bet)
Seat 9: TheMagixFlop (small blind) folded before Flop



PokerStars Hand #245448454702: Tournament #3632677041, $0.23+$0.02 USD Hold'em No Limit - Level XI (400/800) - 2023/08/17 19:18:05 AT [2023/08/17 18:18:05 ET]
Table '3632677041 4' 9-max Seat #9 is the button
Seat 1: vishiwa (16361 in chips) 
Seat 2: Vinteseis36 (7104 in chips) 
Seat 3: frogz69 (7453 in chips) 
Seat 4: fmorandi (5110 in chips) 
Seat 5: Caio Mugarte (3148 in chips) 
Seat 6: kidritalina (11029 in chips) 
Seat 7: rebeLoNrun (4141 in chips) 
Seat 8: SOY PATO355 (9042 in chips) 
Seat 9: TheMagixFlop (4112 in chips) 
vishiwa: posts the ante 50
Vinteseis36: posts the ante 50
frogz69: posts the ante 50
fmorandi: posts the ante 50
Caio Mugarte: posts the ante 50
kidritalina: posts the ante 50
rebeLoNrun: posts the ante 50
SOY PATO355: posts the ante 50
TheMagixFlop: posts the ante 50
vishiwa: posts small blind 400
Vinteseis36: posts big blind 800
*** HOLE CARDS ***
Dealt to Caio Mugarte [Td 8d]
frogz69: folds 
fmorandi: calls 800
Caio Mugarte: folds 
kidritalina: folds 
rebeLoNrun: folds 
SOY PATO355: folds 
TheMagixFlop: folds 
vishiwa: folds 
Vinteseis36: checks 
*** FLOP *** [Ks Qd Js]
Vinteseis36: bets 800
fmorandi: calls 800
*** TURN *** [Ks Qd Js] [9s]
Vinteseis36: checks 
fmorandi: bets 1600
Vinteseis36: folds 
Uncalled bet (1600) returned to fmorandi
fmorandi collected 4050 from pot
*** SUMMARY ***
Total pot 4050 | Rake 0 
Board [Ks Qd Js 9s]
Seat 1: vishiwa (small blind) folded before Flop
Seat 2: Vinteseis36 (big blind) folded on the Turn
Seat 3: frogz69 folded before Flop (didn't bet)
Seat 4: fmorandi collected (4050)
Seat 5: Caio Mugarte folded before Flop (didn't bet)
Seat 6: kidritalina folded before Flop (didn't bet)
Seat 7: rebeLoNrun folded before Flop (didn't bet)
Seat 8: SOY PATO355 folded before Flop (didn't bet)
Seat 9: TheMagixFlop (button) folded before Flop (didn't bet)



PokerStars Hand #245448469885: Tournament #3632677041, $0.23+$0.02 USD Hold'em No Limit - Level XI (400/800) - 2023/08/17 19:18:57 AT [2023/08/17 18:18:57 ET]
Table '3632677041 4' 9-max Seat #1 is the button
Seat 1: vishiwa (15911 in chips) 
Seat 2: Vinteseis36 (5454 in chips) 
Seat 3: frogz69 (7403 in chips) 
Seat 4: fmorandi (7510 in chips) 
Seat 5: Caio Mugarte (3098 in chips) 
Seat 6: kidritalina (10979 in chips) 
Seat 7: rebeLoNrun (4091 in chips) 
Seat 8: SOY PATO355 (8992 in chips) 
Seat 9: TheMagixFlop (4062 in chips) 
vishiwa: posts the ante 50
Vinteseis36: posts the ante 50
frogz69: posts the ante 50
fmorandi: posts the ante 50
Caio Mugarte: posts the ante 50
kidritalina: posts the ante 50
rebeLoNrun: posts the ante 50
SOY PATO355: posts the ante 50
TheMagixFlop: posts the ante 50
Vinteseis36: posts small blind 400
frogz69: posts big blind 800
*** HOLE CARDS ***
Dealt to Caio Mugarte [Ts Tc]
fmorandi: folds 
Caio Mugarte: raises 2248 to 3048 and is all-in
kidritalina: folds 
rebeLoNrun: folds 
SOY PATO355: folds 
TheMagixFlop: folds 
vishiwa: folds 
Vinteseis36: folds 
frogz69: folds 
Uncalled bet (2248) returned to Caio Mugarte
Caio Mugarte collected 2450 from pot
Caio Mugarte: doesn't show hand 
*** SUMMARY ***
Total pot 2450 | Rake 0 
Seat 1: vishiwa (button) folded before Flop (didn't bet)
Seat 2: Vinteseis36 (small blind) folded before Flop
Seat 3: frogz69 (big blind) folded before Flop
Seat 4: fmorandi folded before Flop (didn't bet)
Seat 5: Caio Mugarte collected (2450)
Seat 6: kidritalina folded before Flop (didn't bet)
Seat 7: rebeLoNrun folded before Flop (didn't bet)
Seat 8: SOY PATO355 folded before Flop (didn't bet)
Seat 9: TheMagixFlop folded before Flop (didn't bet)



PokerStars Hand #245448482719: Tournament #3632677041, $0.23+$0.02 USD Hold'em No Limit - Level XI (400/800) - 2023/08/17 19:19:42 AT [2023/08/17 18:19:42 ET]
Table '3632677041 4' 9-max Seat #2 is the button
Seat 1: vishiwa (15861 in chips) 
Seat 2: Vinteseis36 (5004 in chips) 
Seat 3: frogz69 (6553 in chips) 
Seat 4: fmorandi (7460 in chips) 
Seat 5: Caio Mugarte (4698 in chips) 
Seat 6: kidritalina (10929 in chips) 
Seat 7: rebeLoNrun (4041 in chips) 
Seat 8: SOY PATO355 (8942 in chips) 
Seat 9: TheMagixFlop (4012 in chips) 
vishiwa: posts the ante 50
Vinteseis36: posts the ante 50
frogz69: posts the ante 50
fmorandi: posts the ante 50
Caio Mugarte: posts the ante 50
kidritalina: posts the ante 50
rebeLoNrun: posts the ante 50
SOY PATO355: posts the ante 50
TheMagixFlop: posts the ante 50
frogz69: posts small blind 400
fmorandi: posts big blind 800
*** HOLE CARDS ***
Dealt to Caio Mugarte [8h Jc]
Caio Mugarte: folds 
kidritalina: folds 
rebeLoNrun: folds 
SOY PATO355: calls 800
TheMagixFlop: folds 
vishiwa: folds 
Vinteseis36: folds 
frogz69: calls 400
fmorandi: checks 
*** FLOP *** [Kh Ks 9c]
frogz69: checks 
fmorandi: checks 
SOY PATO355: bets 800
frogz69: folds 
fmorandi: folds 
Uncalled bet (800) returned to SOY PATO355
SOY PATO355 collected 2850 from pot
*** SUMMARY ***
Total pot 2850 | Rake 0 
Board [Kh Ks 9c]
Seat 1: vishiwa folded before Flop (didn't bet)
Seat 2: Vinteseis36 (button) folded before Flop (didn't bet)
Seat 3: frogz69 (small blind) folded on the Flop
Seat 4: fmorandi (big blind) folded on the Flop
Seat 5: Caio Mugarte folded before Flop (didn't bet)
Seat 6: kidritalina folded before Flop (didn't bet)
Seat 7: rebeLoNrun folded before Flop (didn't bet)
Seat 8: SOY PATO355 collected (2850)
Seat 9: TheMagixFlop folded before Flop (didn't bet)



PokerStars Hand #245448492559: Tournament #3632677041, $0.23+$0.02 USD Hold'em No Limit - Level XI (400/800) - 2023/08/17 19:20:16 AT [2023/08/17 18:20:16 ET]
Table '3632677041 4' 9-max Seat #3 is the button
Seat 1: vishiwa (15811 in chips) 
Seat 2: Vinteseis36 (4954 in chips) 
Seat 3: frogz69 (5703 in chips) 
Seat 4: fmorandi (6610 in chips) 
Seat 5: Caio Mugarte (4648 in chips) 
Seat 6: kidritalina (10879 in chips) 
Seat 7: rebeLoNrun (3991 in chips) 
Seat 8: SOY PATO355 (10942 in chips) 
Seat 9: TheMagixFlop (3962 in chips) 
vishiwa: posts the ante 50
Vinteseis36: posts the ante 50
frogz69: posts the ante 50
fmorandi: posts the ante 50
Caio Mugarte: posts the ante 50
kidritalina: posts the ante 50
rebeLoNrun: posts the ante 50
SOY PATO355: posts the ante 50
TheMagixFlop: posts the ante 50
fmorandi: posts small blind 400
Caio Mugarte: posts big blind 800
*** HOLE CARDS ***
Dealt to Caio Mugarte [As 4d]
kidritalina: folds 
rebeLoNrun: folds 
SOY PATO355: folds 
TheMagixFlop: folds 
vishiwa: folds 
Vinteseis36: folds 
frogz69: folds 
fmorandi: calls 400
Caio Mugarte: raises 3798 to 4598 and is all-in
fmorandi: folds 
Uncalled bet (3798) returned to Caio Mugarte
Caio Mugarte collected 2050 from pot
Caio Mugarte: doesn't show hand 
*** SUMMARY ***
Total pot 2050 | Rake 0 
Seat 1: vishiwa folded before Flop (didn't bet)
Seat 2: Vinteseis36 folded before Flop (didn't bet)
Seat 3: frogz69 (button) folded before Flop (didn't bet)
Seat 4: fmorandi (small blind) folded before Flop
Seat 5: Caio Mugarte (big blind) collected (2050)
Seat 6: kidritalina folded before Flop (didn't bet)
Seat 7: rebeLoNrun folded before Flop (didn't bet)
Seat 8: SOY PATO355 folded before Flop (didn't bet)
Seat 9: TheMagixFlop folded before Flop (didn't bet)



PokerStars Hand #245448498083: Tournament #3632677041, $0.23+$0.02 USD Hold'em No Limit - Level XI (400/800) - 2023/08/17 19:20:35 AT [2023/08/17 18:20:35 ET]
Table '3632677041 4' 9-max Seat #4 is the button
Seat 1: vishiwa (15761 in chips) 
Seat 2: Vinteseis36 (4904 in chips) 
Seat 3: frogz69 (5653 in chips) 
Seat 4: fmorandi (5760 in chips) 
Seat 5: Caio Mugarte (5848 in chips) 
Seat 6: kidritalina (10829 in chips) 
Seat 7: rebeLoNrun (3941 in chips) 
Seat 8: SOY PATO355 (10892 in chips) 
Seat 9: TheMagixFlop (3912 in chips) 
vishiwa: posts the ante 50
Vinteseis36: posts the ante 50
frogz69: posts the ante 50
fmorandi: posts the ante 50
Caio Mugarte: posts the ante 50
kidritalina: posts the ante 50
rebeLoNrun: posts the ante 50
SOY PATO355: posts the ante 50
TheMagixFlop: posts the ante 50
Caio Mugarte: posts small blind 400
kidritalina: posts big blind 800
*** HOLE CARDS ***
Dealt to Caio Mugarte [4c 2h]
rebeLoNrun: folds 
SOY PATO355: folds 
TheMagixFlop: folds 
vishiwa: folds 
Vinteseis36: folds 
frogz69: folds 
fmorandi: calls 800
Caio Mugarte: folds 
kidritalina: checks 
*** FLOP *** [Ts Tc As]
kidritalina: checks 
fmorandi: checks 
*** TURN *** [Ts Tc As] [4d]
kidritalina: bets 1225
fmorandi: calls 1225
*** RIVER *** [Ts Tc As 4d] [5c]
kidritalina: bets 8754 and is all-in
fmorandi: calls 3685 and is all-in
Uncalled bet (5069) returned to kidritalina
*** SHOW DOWN ***
kidritalina: shows [Kh Jc] (a pair of Tens)
fmorandi: shows [3c Ad] (two pair, Aces and Tens)
fmorandi collected 12270 from pot
*** SUMMARY ***
Total pot 12270 | Rake 0 
Board [Ts Tc As 4d 5c]
Seat 1: vishiwa folded before Flop (didn't bet)
Seat 2: Vinteseis36 folded before Flop (didn't bet)
Seat 3: frogz69 folded before Flop (didn't bet)
Seat 4: fmorandi (button) showed [3c Ad] and won (12270) with two pair, Aces and Tens
Seat 5: Caio Mugarte (small blind) folded before Flop
Seat 6: kidritalina (big blind) showed [Kh Jc] and lost with a pair of Tens
Seat 7: rebeLoNrun folded before Flop (didn't bet)
Seat 8: SOY PATO355 folded before Flop (didn't bet)
Seat 9: TheMagixFlop folded before Flop (didn't bet)



PokerStars Hand #245448513371: Tournament #3632677041, $0.23+$0.02 USD Hold'em No Limit - Level XI (400/800) - 2023/08/17 19:21:27 AT [2023/08/17 18:21:27 ET]
Table '3632677041 4' 9-max Seat #5 is the button
Seat 1: vishiwa (15711 in chips) 
Seat 2: Vinteseis36 (4854 in chips) 
Seat 3: frogz69 (5603 in chips) 
Seat 4: fmorandi (12270 in chips) 
Seat 5: Caio Mugarte (5398 in chips) 
Seat 6: kidritalina (5069 in chips) 
Seat 7: rebeLoNrun (3891 in chips) 
Seat 8: SOY PATO355 (10842 in chips) 
Seat 9: TheMagixFlop (3862 in chips) 
vishiwa: posts the ante 50
Vinteseis36: posts the ante 50
frogz69: posts the ante 50
fmorandi: posts the ante 50
Caio Mugarte: posts the ante 50
kidritalina: posts the ante 50
rebeLoNrun: posts the ante 50
SOY PATO355: posts the ante 50
TheMagixFlop: posts the ante 50
kidritalina: posts small blind 400
rebeLoNrun: posts big blind 800
*** HOLE CARDS ***
Dealt to Caio Mugarte [9d 7d]
SOY PATO355: folds 
TheMagixFlop: folds 
vishiwa: folds 
Vinteseis36: folds 
frogz69: raises 4753 to 5553 and is all-in
fmorandi: calls 5553
Caio Mugarte: folds 
kidritalina: calls 4619 and is all-in
rebeLoNrun: folds 
*** FLOP *** [Th Ad Ks]
*** TURN *** [Th Ad Ks] [2s]
*** RIVER *** [Th Ad Ks 2s] [5c]
*** SHOW DOWN ***
frogz69: shows [Kh Jd] (a pair of Kings)
fmorandi: shows [Kc Ah] (two pair, Aces and Kings)
fmorandi collected 1068 from side pot
kidritalina: shows [3h 8d] (high card Ace)
fmorandi collected 16307 from main pot
frogz69 finished the tournament in 8th place
kidritalina finished the tournament in 9th place
*** SUMMARY ***
Total pot 17375 Main pot 16307. Side pot 1068. | Rake 0 
Board [Th Ad Ks 2s 5c]
Seat 1: vishiwa folded before Flop (didn't bet)
Seat 2: Vinteseis36 folded before Flop (didn't bet)
Seat 3: frogz69 showed [Kh Jd] and lost with a pair of Kings
Seat 4: fmorandi showed [Kc Ah] and won (17375) with two pair, Aces and Kings
Seat 5: Caio Mugarte (button) folded before Flop (didn't bet)
Seat 6: kidritalina (small blind) showed [3h 8d] and lost with high card Ace
Seat 7: rebeLoNrun (big blind) folded before Flop
Seat 8: SOY PATO355 folded before Flop (didn't bet)
Seat 9: TheMagixFlop folded before Flop (didn't bet)



PokerStars Hand #245448524727: Tournament #3632677041, $0.23+$0.02 USD Hold'em No Limit - Level XI (400/800) - 2023/08/17 19:22:06 AT [2023/08/17 18:22:06 ET]
Table '3632677041 4' 9-max Seat #7 is the button
Seat 1: vishiwa (15661 in chips) 
Seat 2: Vinteseis36 (4804 in chips) 
Seat 4: fmorandi (24042 in chips) 
Seat 5: Caio Mugarte (5348 in chips) 
Seat 7: rebeLoNrun (3041 in chips) 
Seat 8: SOY PATO355 (10792 in chips) 
Seat 9: TheMagixFlop (3812 in chips) 
vishiwa: posts the ante 50
Vinteseis36: posts the ante 50
fmorandi: posts the ante 50
Caio Mugarte: posts the ante 50
rebeLoNrun: posts the ante 50
SOY PATO355: posts the ante 50
TheMagixFlop: posts the ante 50
SOY PATO355: posts small blind 400
TheMagixFlop: posts big blind 800
*** HOLE CARDS ***
Dealt to Caio Mugarte [6s 5s]
vishiwa: folds 
Vinteseis36: folds 
fmorandi: folds 
Caio Mugarte: folds 
rebeLoNrun: raises 2191 to 2991 and is all-in
SOY PATO355: calls 2591
TheMagixFlop: folds 
*** FLOP *** [9d Ad 4h]
*** TURN *** [9d Ad 4h] [6h]
*** RIVER *** [9d Ad 4h 6h] [7s]
*** SHOW DOWN ***
SOY PATO355: shows [Jh Kc] (high card Ace)
rebeLoNrun: shows [6c Kh] (a pair of Sixes)
rebeLoNrun collected 7132 from pot
*** SUMMARY ***
Total pot 7132 | Rake 0 
Board [9d Ad 4h 6h 7s]
Seat 1: vishiwa folded before Flop (didn't bet)
Seat 2: Vinteseis36 folded before Flop (didn't bet)
Seat 4: fmorandi folded before Flop (didn't bet)
Seat 5: Caio Mugarte folded before Flop (didn't bet)
Seat 7: rebeLoNrun (button) showed [6c Kh] and won (7132) with a pair of Sixes
Seat 8: SOY PATO355 (small blind) showed [Jh Kc] and lost with high card Ace
Seat 9: TheMagixFlop (big blind) folded before Flop



PokerStars Hand #245448533695: Tournament #3632677041, $0.23+$0.02 USD Hold'em No Limit - Level XI (400/800) - 2023/08/17 19:22:36 AT [2023/08/17 18:22:36 ET]
Table '3632677041 4' 9-max Seat #8 is the button
Seat 1: vishiwa (15611 in chips) 
Seat 2: Vinteseis36 (4754 in chips) 
Seat 4: fmorandi (23992 in chips) 
Seat 5: Caio Mugarte (5298 in chips) 
Seat 7: rebeLoNrun (7132 in chips) 
Seat 8: SOY PATO355 (7751 in chips) 
Seat 9: TheMagixFlop (2962 in chips) 
vishiwa: posts the ante 50
Vinteseis36: posts the ante 50
fmorandi: posts the ante 50
Caio Mugarte: posts the ante 50
rebeLoNrun: posts the ante 50
SOY PATO355: posts the ante 50
TheMagixFlop: posts the ante 50
TheMagixFlop: posts small blind 400
vishiwa: posts big blind 800
*** HOLE CARDS ***
Dealt to Caio Mugarte [Kh 7d]
Vinteseis36: folds 
fmorandi: folds 
Caio Mugarte: folds 
rebeLoNrun: folds 
SOY PATO355: raises 800 to 1600
TheMagixFlop: folds 
vishiwa: calls 800
*** FLOP *** [8h Th 8s]
vishiwa: checks 
SOY PATO355: bets 1600
vishiwa: calls 1600
*** TURN *** [8h Th 8s] [6h]
vishiwa: checks 
SOY PATO355: checks 
*** RIVER *** [8h Th 8s 6h] [Tc]
vishiwa: bets 1600
SOY PATO355: calls 1600
*** SHOW DOWN ***
vishiwa: shows [9c Jc] (two pair, Tens and Eights)
SOY PATO355: shows [Jd Js] (two pair, Jacks and Tens)
SOY PATO355 collected 10350 from pot
*** SUMMARY ***
Total pot 10350 | Rake 0 
Board [8h Th 8s 6h Tc]
Seat 1: vishiwa (big blind) showed [9c Jc] and lost with two pair, Tens and Eights
Seat 2: Vinteseis36 folded before Flop (didn't bet)
Seat 4: fmorandi folded before Flop (didn't bet)
Seat 5: Caio Mugarte folded before Flop (didn't bet)
Seat 7: rebeLoNrun folded before Flop (didn't bet)
Seat 8: SOY PATO355 (button) showed [Jd Js] and won (10350) with two pair, Jacks and Tens
Seat 9: TheMagixFlop (small blind) folded before Flop



PokerStars Hand #245448545878: Tournament #3632677041, $0.23+$0.02 USD Hold'em No Limit - Level XI (400/800) - 2023/08/17 19:23:18 AT [2023/08/17 18:23:18 ET]
Table '3632677041 4' 9-max Seat #9 is the button
Seat 1: vishiwa (10761 in chips) 
Seat 2: Vinteseis36 (4704 in chips) 
Seat 4: fmorandi (23942 in chips) 
Seat 5: Caio Mugarte (5248 in chips) 
Seat 7: rebeLoNrun (7082 in chips) 
Seat 8: SOY PATO355 (13251 in chips) 
Seat 9: TheMagixFlop (2512 in chips) 
vishiwa: posts the ante 50
Vinteseis36: posts the ante 50
fmorandi: posts the ante 50
Caio Mugarte: posts the ante 50
rebeLoNrun: posts the ante 50
SOY PATO355: posts the ante 50
TheMagixFlop: posts the ante 50
vishiwa: posts small blind 400
Vinteseis36: posts big blind 800
*** HOLE CARDS ***
Dealt to Caio Mugarte [5s 5h]
fmorandi: folds 
Caio Mugarte: raises 4398 to 5198 and is all-in
rebeLoNrun: folds 
SOY PATO355: folds 
TheMagixFlop: folds 
vishiwa: folds 
SOY PATO355 is disconnected 
Vinteseis36: folds 
Uncalled bet (4398) returned to Caio Mugarte
SOY PATO355 is disconnected 
Caio Mugarte collected 2350 from pot
Caio Mugarte: doesn't show hand 
*** SUMMARY ***
Total pot 2350 | Rake 0 
Seat 1: vishiwa (small blind) folded before Flop
Seat 2: Vinteseis36 (big blind) folded before Flop
Seat 4: fmorandi folded before Flop (didn't bet)
Seat 5: Caio Mugarte collected (2350)
Seat 7: rebeLoNrun folded before Flop (didn't bet)
Seat 8: SOY PATO355 folded before Flop (didn't bet)
Seat 9: TheMagixFlop (button) folded before Flop (didn't bet)



PokerStars Hand #245448556470: Tournament #3632677041, $0.23+$0.02 USD Hold'em No Limit - Level XI (400/800) - 2023/08/17 19:23:54 AT [2023/08/17 18:23:54 ET]
Table '3632677041 4' 9-max Seat #1 is the button
Seat 1: vishiwa (10311 in chips) 
Seat 2: Vinteseis36 (3854 in chips) 
Seat 4: fmorandi (23892 in chips) 
Seat 5: Caio Mugarte (6748 in chips) 
Seat 7: rebeLoNrun (7032 in chips) 
Seat 8: SOY PATO355 (13201 in chips) 
Seat 9: TheMagixFlop (2462 in chips) 
vishiwa: posts the ante 50
Vinteseis36: posts the ante 50
fmorandi: posts the ante 50
Caio Mugarte: posts the ante 50
rebeLoNrun: posts the ante 50
SOY PATO355: posts the ante 50
TheMagixFlop: posts the ante 50
Vinteseis36: posts small blind 400
fmorandi: posts big blind 800
*** HOLE CARDS ***
Dealt to Caio Mugarte [7c 8d]
Caio Mugarte: folds 
rebeLoNrun: folds 
SOY PATO355: folds 
TheMagixFlop: folds 
vishiwa: folds 
Vinteseis36: folds 
Uncalled bet (400) returned to fmorandi
fmorandi collected 1150 from pot
*** SUMMARY ***
Total pot 1150 | Rake 0 
Seat 1: vishiwa (button) folded before Flop (didn't bet)
Seat 2: Vinteseis36 (small blind) folded before Flop
Seat 4: fmorandi (big blind) collected (1150)
Seat 5: Caio Mugarte folded before Flop (didn't bet)
Seat 7: rebeLoNrun folded before Flop (didn't bet)
Seat 8: SOY PATO355 folded before Flop (didn't bet)
Seat 9: TheMagixFlop folded before Flop (didn't bet)



PokerStars Hand #245448567146: Tournament #3632677041, $0.23+$0.02 USD Hold'em No Limit - Level XI (400/800) - 2023/08/17 19:24:31 AT [2023/08/17 18:24:31 ET]
Table '3632677041 4' 9-max Seat #2 is the button
Seat 1: vishiwa (10261 in chips) 
Seat 2: Vinteseis36 (3404 in chips) 
Seat 4: fmorandi (24592 in chips) 
Seat 5: Caio Mugarte (6698 in chips) 
Seat 7: rebeLoNrun (6982 in chips) 
Seat 8: SOY PATO355 (13151 in chips) 
Seat 9: TheMagixFlop (2412 in chips) 
vishiwa: posts the ante 50
Vinteseis36: posts the ante 50
fmorandi: posts the ante 50
Caio Mugarte: posts the ante 50
rebeLoNrun: posts the ante 50
SOY PATO355: posts the ante 50
TheMagixFlop: posts the ante 50
fmorandi: posts small blind 400
Caio Mugarte: posts big blind 800
*** HOLE CARDS ***
Dealt to Caio Mugarte [6h 8d]
rebeLoNrun: folds 
SOY PATO355: folds 
TheMagixFlop: folds 
vishiwa: folds 
Vinteseis36: folds 
fmorandi: folds 
Uncalled bet (400) returned to Caio Mugarte
Caio Mugarte collected 1150 from pot
Caio Mugarte: doesn't show hand 
*** SUMMARY ***
Total pot 1150 | Rake 0 
Seat 1: vishiwa folded before Flop (didn't bet)
Seat 2: Vinteseis36 (button) folded before Flop (didn't bet)
Seat 4: fmorandi (small blind) folded before Flop
Seat 5: Caio Mugarte (big blind) collected (1150)
Seat 7: rebeLoNrun folded before Flop (didn't bet)
Seat 8: SOY PATO355 folded before Flop (didn't bet)
Seat 9: TheMagixFlop folded before Flop (didn't bet)



PokerStars Hand #245448576083: Tournament #3632677041, $0.23+$0.02 USD Hold'em No Limit - Level XI (400/800) - 2023/08/17 19:25:01 AT [2023/08/17 18:25:01 ET]
Table '3632677041 4' 9-max Seat #4 is the button
Seat 1: vishiwa (10211 in chips) 
Seat 2: Vinteseis36 (3354 in chips) 
Seat 4: fmorandi (24142 in chips) 
Seat 5: Caio Mugarte (7398 in chips) 
Seat 7: rebeLoNrun (6932 in chips) 
Seat 8: SOY PATO355 (13101 in chips) 
Seat 9: TheMagixFlop (2362 in chips) 
vishiwa: posts the ante 50
Vinteseis36: posts the ante 50
fmorandi: posts the ante 50
Caio Mugarte: posts the ante 50
rebeLoNrun: posts the ante 50
SOY PATO355: posts the ante 50
TheMagixFlop: posts the ante 50
Caio Mugarte: posts small blind 400
rebeLoNrun: posts big blind 800
*** HOLE CARDS ***
Dealt to Caio Mugarte [Ah 4s]
SOY PATO355: folds 
TheMagixFlop: folds 
vishiwa: folds 
Vinteseis36: folds 
fmorandi: folds 
Caio Mugarte: raises 6548 to 7348 and is all-in
rebeLoNrun: folds 
Uncalled bet (6548) returned to Caio Mugarte
Caio Mugarte collected 1950 from pot
Caio Mugarte: doesn't show hand 
*** SUMMARY ***
Total pot 1950 | Rake 0 
Seat 1: vishiwa folded before Flop (didn't bet)
Seat 2: Vinteseis36 folded before Flop (didn't bet)
Seat 4: fmorandi (button) folded before Flop (didn't bet)
Seat 5: Caio Mugarte (small blind) collected (1950)
Seat 7: rebeLoNrun (big blind) folded before Flop
Seat 8: SOY PATO355 folded before Flop (didn't bet)
Seat 9: TheMagixFlop folded before Flop (didn't bet)



PokerStars Hand #245448584398: Tournament #3632677041, $0.23+$0.02 USD Hold'em No Limit - Level XII (500/1000) - 2023/08/17 19:25:30 AT [2023/08/17 18:25:30 ET]
Table '3632677041 4' 9-max Seat #5 is the button
Seat 1: vishiwa (10161 in chips) 
Seat 2: Vinteseis36 (3304 in chips) 
Seat 4: fmorandi (24092 in chips) 
Seat 5: Caio Mugarte (8498 in chips) 
Seat 7: rebeLoNrun (6082 in chips) 
Seat 8: SOY PATO355 (13051 in chips) 
Seat 9: TheMagixFlop (2312 in chips) 
vishiwa: posts the ante 60
Vinteseis36: posts the ante 60
fmorandi: posts the ante 60
Caio Mugarte: posts the ante 60
rebeLoNrun: posts the ante 60
SOY PATO355: posts the ante 60
TheMagixFlop: posts the ante 60
rebeLoNrun: posts small blind 500
SOY PATO355: posts big blind 1000
*** HOLE CARDS ***
Dealt to Caio Mugarte [3d Ad]
TheMagixFlop: raises 1252 to 2252 and is all-in
vishiwa: folds 
Vinteseis36: folds 
fmorandi: folds 
Caio Mugarte: folds 
rebeLoNrun: folds 
SOY PATO355: calls 1252
*** FLOP *** [Ts Jc 6d]
*** TURN *** [Ts Jc 6d] [Qd]
*** RIVER *** [Ts Jc 6d Qd] [5s]
*** SHOW DOWN ***
SOY PATO355: shows [8h Js] (a pair of Jacks)
TheMagixFlop: shows [6h Ah] (a pair of Sixes)
SOY PATO355 collected 5424 from pot
TheMagixFlop finished the tournament in 7th place and received $0.45.
*** SUMMARY ***
Total pot 5424 | Rake 0 
Board [Ts Jc 6d Qd 5s]
Seat 1: vishiwa folded before Flop (didn't bet)
Seat 2: Vinteseis36 folded before Flop (didn't bet)
Seat 4: fmorandi folded before Flop (didn't bet)
Seat 5: Caio Mugarte (button) folded before Flop (didn't bet)
Seat 7: rebeLoNrun (small blind) folded before Flop
Seat 8: SOY PATO355 (big blind) showed [8h Js] and won (5424) with a pair of Jacks
Seat 9: TheMagixFlop showed [6h Ah] and lost with a pair of Sixes



PokerStars Hand #245448597941: Tournament #3632677041, $0.23+$0.02 USD Hold'em No Limit - Level XII (500/1000) - 2023/08/17 19:26:16 AT [2023/08/17 18:26:16 ET]
Table '3632677041 4' 9-max Seat #7 is the button
Seat 1: vishiwa (10101 in chips) 
Seat 2: Vinteseis36 (3244 in chips) 
Seat 4: fmorandi (24032 in chips) 
Seat 5: Caio Mugarte (8438 in chips) 
Seat 7: rebeLoNrun (5522 in chips) 
Seat 8: SOY PATO355 (16163 in chips) 
vishiwa: posts the ante 60
Vinteseis36: posts the ante 60
fmorandi: posts the ante 60
Caio Mugarte: posts the ante 60
rebeLoNrun: posts the ante 60
SOY PATO355: posts the ante 60
SOY PATO355: posts small blind 500
vishiwa: posts big blind 1000
*** HOLE CARDS ***
Dealt to Caio Mugarte [3d Ah]
Vinteseis36: folds 
fmorandi: calls 1000
Caio Mugarte: folds 
rebeLoNrun: folds 
SOY PATO355: calls 500
vishiwa: checks 
*** FLOP *** [Kh 5d 7c]
SOY PATO355: checks 
vishiwa: checks 
fmorandi: checks 
*** TURN *** [Kh 5d 7c] [Tc]
SOY PATO355: bets 1000
vishiwa: calls 1000
fmorandi: calls 1000
*** RIVER *** [Kh 5d 7c Tc] [Ts]
SOY PATO355: checks 
vishiwa: checks 
fmorandi: checks 
*** SHOW DOWN ***
SOY PATO355: shows [8h Ks] (two pair, Kings and Tens)
vishiwa: mucks hand 
fmorandi: mucks hand 
SOY PATO355 collected 6360 from pot
*** SUMMARY ***
Total pot 6360 | Rake 0 
Board [Kh 5d 7c Tc Ts]
Seat 1: vishiwa (big blind) mucked [Jh Qc]
Seat 2: Vinteseis36 folded before Flop (didn't bet)
Seat 4: fmorandi mucked [As 9c]
Seat 5: Caio Mugarte folded before Flop (didn't bet)
Seat 7: rebeLoNrun (button) folded before Flop (didn't bet)
Seat 8: SOY PATO355 (small blind) showed [8h Ks] and won (6360) with two pair, Kings and Tens



PokerStars Hand #245448617407: Tournament #3632677041, $0.23+$0.02 USD Hold'em No Limit - Level XII (500/1000) - 2023/08/17 19:27:23 AT [2023/08/17 18:27:23 ET]
Table '3632677041 4' 9-max Seat #8 is the button
Seat 1: vishiwa (8041 in chips) 
Seat 2: Vinteseis36 (3184 in chips) 
Seat 4: fmorandi (21972 in chips) 
Seat 5: Caio Mugarte (8378 in chips) 
Seat 7: rebeLoNrun (5462 in chips) 
Seat 8: SOY PATO355 (20463 in chips) 
vishiwa: posts the ante 60
Vinteseis36: posts the ante 60
fmorandi: posts the ante 60
Caio Mugarte: posts the ante 60
rebeLoNrun: posts the ante 60
SOY PATO355: posts the ante 60
vishiwa: posts small blind 500
Vinteseis36: posts big blind 1000
*** HOLE CARDS ***
Dealt to Caio Mugarte [6d Ts]
fmorandi: folds 
Caio Mugarte: folds 
rebeLoNrun: folds 
SOY PATO355: raises 1000 to 2000
vishiwa: folds 
Vinteseis36: calls 1000
*** FLOP *** [Kh 8d Qs]
Vinteseis36: bets 1000
SOY PATO355: raises 1000 to 2000
Vinteseis36: calls 124 and is all-in
Uncalled bet (876) returned to SOY PATO355
*** TURN *** [Kh 8d Qs] [Kd]
*** RIVER *** [Kh 8d Qs Kd] [4d]
*** SHOW DOWN ***
Vinteseis36: shows [Qd 3d] (a flush, King high)
SOY PATO355: shows [Jh Qc] (two pair, Kings and Queens)
Vinteseis36 collected 7108 from pot
*** SUMMARY ***
Total pot 7108 | Rake 0 
Board [Kh 8d Qs Kd 4d]
Seat 1: vishiwa (small blind) folded before Flop
Seat 2: Vinteseis36 (big blind) showed [Qd 3d] and won (7108) with a flush, King high
Seat 4: fmorandi folded before Flop (didn't bet)
Seat 5: Caio Mugarte folded before Flop (didn't bet)
Seat 7: rebeLoNrun folded before Flop (didn't bet)
Seat 8: SOY PATO355 (button) showed [Jh Qc] and lost with two pair, Kings and Queens



PokerStars Hand #245448627544: Tournament #3632677041, $0.23+$0.02 USD Hold'em No Limit - Level XII (500/1000) - 2023/08/17 19:27:57 AT [2023/08/17 18:27:57 ET]
Table '3632677041 4' 9-max Seat #1 is the button
Seat 1: vishiwa (7481 in chips) 
Seat 2: Vinteseis36 (7108 in chips) 
Seat 4: fmorandi (21912 in chips) 
Seat 5: Caio Mugarte (8318 in chips) 
Seat 7: rebeLoNrun (5402 in chips) 
Seat 8: SOY PATO355 (17279 in chips) 
vishiwa: posts the ante 60
Vinteseis36: posts the ante 60
fmorandi: posts the ante 60
Caio Mugarte: posts the ante 60
rebeLoNrun: posts the ante 60
SOY PATO355: posts the ante 60
Vinteseis36: posts small blind 500
fmorandi: posts big blind 1000
*** HOLE CARDS ***
Dealt to Caio Mugarte [8h Jd]
Caio Mugarte: folds 
rebeLoNrun: folds 
SOY PATO355: folds 
vishiwa: folds 
Vinteseis36: folds 
Uncalled bet (500) returned to fmorandi
fmorandi collected 1360 from pot
*** SUMMARY ***
Total pot 1360 | Rake 0 
Seat 1: vishiwa (button) folded before Flop (didn't bet)
Seat 2: Vinteseis36 (small blind) folded before Flop
Seat 4: fmorandi (big blind) collected (1360)
Seat 5: Caio Mugarte folded before Flop (didn't bet)
Seat 7: rebeLoNrun folded before Flop (didn't bet)
Seat 8: SOY PATO355 folded before Flop (didn't bet)



PokerStars Hand #245448633420: Tournament #3632677041, $0.23+$0.02 USD Hold'em No Limit - Level XII (500/1000) - 2023/08/17 19:28:17 AT [2023/08/17 18:28:17 ET]
Table '3632677041 4' 9-max Seat #2 is the button
Seat 1: vishiwa (7421 in chips) 
Seat 2: Vinteseis36 (6548 in chips) 
Seat 4: fmorandi (22712 in chips) 
Seat 5: Caio Mugarte (8258 in chips) 
Seat 7: rebeLoNrun (5342 in chips) 
Seat 8: SOY PATO355 (17219 in chips) 
vishiwa: posts the ante 60
Vinteseis36: posts the ante 60
fmorandi: posts the ante 60
Caio Mugarte: posts the ante 60
rebeLoNrun: posts the ante 60
SOY PATO355: posts the ante 60
fmorandi: posts small blind 500
Caio Mugarte: posts big blind 1000
*** HOLE CARDS ***
Dealt to Caio Mugarte [7s 7h]
rebeLoNrun: folds 
SOY PATO355: folds 
vishiwa: raises 2000 to 3000
Vinteseis36: folds 
fmorandi: folds 
Caio Mugarte: raises 5198 to 8198 and is all-in
vishiwa: calls 4361 and is all-in
Uncalled bet (837) returned to Caio Mugarte
*** FLOP *** [3c Jh 9c]
*** TURN *** [3c Jh 9c] [Ks]
*** RIVER *** [3c Jh 9c Ks] [7d]
*** SHOW DOWN ***
Caio Mugarte: shows [7s 7h] (three of a kind, Sevens)
vishiwa: shows [Js Ac] (a pair of Jacks)
Caio Mugarte collected 15582 from pot
vishiwa finished the tournament in 6th place and received $0.62.
*** SUMMARY ***
Total pot 15582 | Rake 0 
Board [3c Jh 9c Ks 7d]
Seat 1: vishiwa showed [Js Ac] and lost with a pair of Jacks
Seat 2: Vinteseis36 (button) folded before Flop (didn't bet)
Seat 4: fmorandi (small blind) folded before Flop
Seat 5: Caio Mugarte (big blind) showed [7s 7h] and won (15582) with three of a kind, Sevens
Seat 7: rebeLoNrun folded before Flop (didn't bet)
Seat 8: SOY PATO355 folded before Flop (didn't bet)



PokerStars Hand #245448640810: Tournament #3632677041, $0.23+$0.02 USD Hold'em No Limit - Level XII (500/1000) - 2023/08/17 19:28:43 AT [2023/08/17 18:28:43 ET]
Table '3632677041 4' 9-max Seat #4 is the button
Seat 2: Vinteseis36 (6488 in chips) 
Seat 4: fmorandi (22152 in chips) 
Seat 5: Caio Mugarte (16419 in chips) 
Seat 7: rebeLoNrun (5282 in chips) 
Seat 8: SOY PATO355 (17159 in chips) 
Vinteseis36: posts the ante 60
fmorandi: posts the ante 60
Caio Mugarte: posts the ante 60
rebeLoNrun: posts the ante 60
SOY PATO355: posts the ante 60
Caio Mugarte: posts small blind 500
rebeLoNrun: posts big blind 1000
*** HOLE CARDS ***
Dealt to Caio Mugarte [Kc 9h]
SOY PATO355: calls 1000
Vinteseis36: folds 
fmorandi: folds 
Caio Mugarte: folds 
rebeLoNrun: raises 4222 to 5222 and is all-in
SOY PATO355: calls 4222
*** FLOP *** [Ad 5d Qd]
*** TURN *** [Ad 5d Qd] [9c]
*** RIVER *** [Ad 5d Qd 9c] [Ah]
*** SHOW DOWN ***
rebeLoNrun: shows [Qs Qc] (a full house, Queens full of Aces)
SOY PATO355: shows [7d 7h] (two pair, Aces and Sevens)
rebeLoNrun collected 11244 from pot
*** SUMMARY ***
Total pot 11244 | Rake 0 
Board [Ad 5d Qd 9c Ah]
Seat 2: Vinteseis36 folded before Flop (didn't bet)
Seat 4: fmorandi (button) folded before Flop (didn't bet)
Seat 5: Caio Mugarte (small blind) folded before Flop
Seat 7: rebeLoNrun (big blind) showed [Qs Qc] and won (11244) with a full house, Queens full of Aces
Seat 8: SOY PATO355 showed [7d 7h] and lost with two pair, Aces and Sevens



PokerStars Hand #245448647281: Tournament #3632677041, $0.23+$0.02 USD Hold'em No Limit - Level XII (500/1000) - 2023/08/17 19:29:05 AT [2023/08/17 18:29:05 ET]
Table '3632677041 4' 9-max Seat #5 is the button
Seat 2: Vinteseis36 (6428 in chips) 
Seat 4: fmorandi (22092 in chips) 
Seat 5: Caio Mugarte (15859 in chips) 
Seat 7: rebeLoNrun (11244 in chips) 
Seat 8: SOY PATO355 (11877 in chips) 
Vinteseis36: posts the ante 60
fmorandi: posts the ante 60
Caio Mugarte: posts the ante 60
rebeLoNrun: posts the ante 60
SOY PATO355: posts the ante 60
rebeLoNrun: posts small blind 500
SOY PATO355: posts big blind 1000
*** HOLE CARDS ***
Dealt to Caio Mugarte [6s Ks]
Vinteseis36: folds 
fmorandi: folds 
Caio Mugarte: raises 1000 to 2000
rebeLoNrun: folds 
SOY PATO355: folds 
Uncalled bet (1000) returned to Caio Mugarte
Caio Mugarte collected 2800 from pot
Caio Mugarte: doesn't show hand 
*** SUMMARY ***
Total pot 2800 | Rake 0 
Seat 2: Vinteseis36 folded before Flop (didn't bet)
Seat 4: fmorandi folded before Flop (didn't bet)
Seat 5: Caio Mugarte (button) collected (2800)
Seat 7: rebeLoNrun (small blind) folded before Flop
Seat 8: SOY PATO355 (big blind) folded before Flop



PokerStars Hand #245448650399: Tournament #3632677041, $0.23+$0.02 USD Hold'em No Limit - Level XII (500/1000) - 2023/08/17 19:29:16 AT [2023/08/17 18:29:16 ET]
Table '3632677041 4' 9-max Seat #7 is the button
Seat 2: Vinteseis36 (6368 in chips) 
Seat 4: fmorandi (22032 in chips) 
Seat 5: Caio Mugarte (17599 in chips) 
Seat 7: rebeLoNrun (10684 in chips) 
Seat 8: SOY PATO355 (10817 in chips) 
Vinteseis36: posts the ante 60
fmorandi: posts the ante 60
Caio Mugarte: posts the ante 60
rebeLoNrun: posts the ante 60
SOY PATO355: posts the ante 60
SOY PATO355: posts small blind 500
Vinteseis36: posts big blind 1000
*** HOLE CARDS ***
Dealt to Caio Mugarte [Ts 4c]
fmorandi: calls 1000
Caio Mugarte: folds 
rebeLoNrun: folds 
SOY PATO355: calls 500
Vinteseis36: checks 
*** FLOP *** [2d 5c 5h]
SOY PATO355: checks 
Vinteseis36: checks 
fmorandi: checks 
*** TURN *** [2d 5c 5h] [3c]
SOY PATO355: bets 1000
Vinteseis36: folds 
fmorandi: calls 1000
*** RIVER *** [2d 5c 5h 3c] [Qd]
SOY PATO355: checks 
fmorandi: checks 
*** SHOW DOWN ***
SOY PATO355: shows [7s 9s] (a pair of Fives)
fmorandi: shows [Jd 9d] (a pair of Fives - Queen+Jack kicker)
fmorandi collected 5300 from pot
*** SUMMARY ***
Total pot 5300 | Rake 0 
Board [2d 5c 5h 3c Qd]
Seat 2: Vinteseis36 (big blind) folded on the Turn
Seat 4: fmorandi showed [Jd 9d] and won (5300) with a pair of Fives
Seat 5: Caio Mugarte folded before Flop (didn't bet)
Seat 7: rebeLoNrun (button) folded before Flop (didn't bet)
Seat 8: SOY PATO355 (small blind) showed [7s 9s] and lost with a pair of Fives



PokerStars Hand #245448662404: Tournament #3632677041, $0.23+$0.02 USD Hold'em No Limit - Level XII (500/1000) - 2023/08/17 19:29:58 AT [2023/08/17 18:29:58 ET]
Table '3632677041 4' 9-max Seat #8 is the button
Seat 2: Vinteseis36 (5308 in chips) 
Seat 4: fmorandi (25272 in chips) 
Seat 5: Caio Mugarte (17539 in chips) 
Seat 7: rebeLoNrun (10624 in chips) 
Seat 8: SOY PATO355 (8757 in chips) 
Vinteseis36: posts the ante 60
fmorandi: posts the ante 60
Caio Mugarte: posts the ante 60
rebeLoNrun: posts the ante 60
SOY PATO355: posts the ante 60
Vinteseis36: posts small blind 500
fmorandi: posts big blind 1000
*** HOLE CARDS ***
Dealt to Caio Mugarte [7s 6s]
Caio Mugarte: folds 
rebeLoNrun: folds 
SOY PATO355: calls 1000
Vinteseis36: folds 
fmorandi: checks 
*** FLOP *** [5h 4h Jd]
fmorandi: checks 
SOY PATO355: bets 1000
fmorandi: folds 
Uncalled bet (1000) returned to SOY PATO355
SOY PATO355 collected 2800 from pot
SOY PATO355: doesn't show hand 
*** SUMMARY ***
Total pot 2800 | Rake 0 
Board [5h 4h Jd]
Seat 2: Vinteseis36 (small blind) folded before Flop
Seat 4: fmorandi (big blind) folded on the Flop
Seat 5: Caio Mugarte folded before Flop (didn't bet)
Seat 7: rebeLoNrun folded before Flop (didn't bet)
Seat 8: SOY PATO355 (button) collected (2800)



PokerStars Hand #245448669503: Tournament #3632677041, $0.23+$0.02 USD Hold'em No Limit - Level XII (500/1000) - 2023/08/17 19:30:22 AT [2023/08/17 18:30:22 ET]
Table '3632677041 4' 9-max Seat #2 is the button
Seat 2: Vinteseis36 (4748 in chips) 
Seat 4: fmorandi (24212 in chips) 
Seat 5: Caio Mugarte (17479 in chips) 
Seat 7: rebeLoNrun (10564 in chips) 
Seat 8: SOY PATO355 (10497 in chips) 
Vinteseis36: posts the ante 60
fmorandi: posts the ante 60
Caio Mugarte: posts the ante 60
rebeLoNrun: posts the ante 60
SOY PATO355: posts the ante 60
fmorandi: posts small blind 500
Caio Mugarte: posts big blind 1000
*** HOLE CARDS ***
Dealt to Caio Mugarte [Td 2c]
rebeLoNrun: folds 
SOY PATO355: raises 1000 to 2000
Vinteseis36: raises 2688 to 4688 and is all-in
fmorandi: folds 
Caio Mugarte: folds 
SOY PATO355: calls 2688
*** FLOP *** [2d Qd 8s]
*** TURN *** [2d Qd 8s] [5c]
*** RIVER *** [2d Qd 8s 5c] [4s]
*** SHOW DOWN ***
SOY PATO355: shows [9h 9d] (a pair of Nines)
Vinteseis36: shows [5d 5h] (three of a kind, Fives)
Vinteseis36 collected 11176 from pot
*** SUMMARY ***
Total pot 11176 | Rake 0 
Board [2d Qd 8s 5c 4s]
Seat 2: Vinteseis36 (button) showed [5d 5h] and won (11176) with three of a kind, Fives
Seat 4: fmorandi (small blind) folded before Flop
Seat 5: Caio Mugarte (big blind) folded before Flop
Seat 7: rebeLoNrun folded before Flop (didn't bet)
Seat 8: SOY PATO355 showed [9h 9d] and lost with a pair of Nines



PokerStars Hand #245448677825: Tournament #3632677041, $0.23+$0.02 USD Hold'em No Limit - Level XII (500/1000) - 2023/08/17 19:30:51 AT [2023/08/17 18:30:51 ET]
Table '3632677041 4' 9-max Seat #4 is the button
Seat 2: Vinteseis36 (11176 in chips) 
Seat 4: fmorandi (23652 in chips) 
Seat 5: Caio Mugarte (16419 in chips) 
Seat 7: rebeLoNrun (10504 in chips) 
Seat 8: SOY PATO355 (5749 in chips) 
Vinteseis36: posts the ante 60
fmorandi: posts the ante 60
Caio Mugarte: posts the ante 60
rebeLoNrun: posts the ante 60
SOY PATO355: posts the ante 60
Caio Mugarte: posts small blind 500
rebeLoNrun: posts big blind 1000
*** HOLE CARDS ***
Dealt to Caio Mugarte [Ks Ac]
SOY PATO355: folds 
Vinteseis36: folds 
fmorandi: folds 
Caio Mugarte: raises 15359 to 16359 and is all-in
rebeLoNrun: folds 
Uncalled bet (15359) returned to Caio Mugarte
Caio Mugarte collected 2300 from pot
Caio Mugarte: doesn't show hand 
*** SUMMARY ***
Total pot 2300 | Rake 0 
Seat 2: Vinteseis36 folded before Flop (didn't bet)
Seat 4: fmorandi (button) folded before Flop (didn't bet)
Seat 5: Caio Mugarte (small blind) collected (2300)
Seat 7: rebeLoNrun (big blind) folded before Flop
Seat 8: SOY PATO355 folded before Flop (didn't bet)



PokerStars Hand #245448681649: Tournament #3632677041, $0.23+$0.02 USD Hold'em No Limit - Level XII (500/1000) - 2023/08/17 19:31:04 AT [2023/08/17 18:31:04 ET]
Table '3632677041 4' 9-max Seat #5 is the button
Seat 2: Vinteseis36 (11116 in chips) 
Seat 4: fmorandi (23592 in chips) 
Seat 5: Caio Mugarte (17659 in chips) 
Seat 7: rebeLoNrun (9444 in chips) 
Seat 8: SOY PATO355 (5689 in chips) 
Vinteseis36: posts the ante 60
fmorandi: posts the ante 60
Caio Mugarte: posts the ante 60
rebeLoNrun: posts the ante 60
SOY PATO355: posts the ante 60
rebeLoNrun: posts small blind 500
SOY PATO355: posts big blind 1000
*** HOLE CARDS ***
Dealt to Caio Mugarte [Kh 6h]
Vinteseis36: folds 
fmorandi: calls 1000
Caio Mugarte: folds 
rebeLoNrun: calls 500
SOY PATO355: checks 
*** FLOP *** [Js 4c Qd]
rebeLoNrun: checks 
SOY PATO355: bets 4629 and is all-in
fmorandi: folds 
rebeLoNrun: folds 
Uncalled bet (4629) returned to SOY PATO355
SOY PATO355 collected 3300 from pot
SOY PATO355: doesn't show hand 
*** SUMMARY ***
Total pot 3300 | Rake 0 
Board [Js 4c Qd]
Seat 2: Vinteseis36 folded before Flop (didn't bet)
Seat 4: fmorandi folded on the Flop
Seat 5: Caio Mugarte (button) folded before Flop (didn't bet)
Seat 7: rebeLoNrun (small blind) folded on the Flop
Seat 8: SOY PATO355 (big blind) collected (3300)



PokerStars Hand #245448693986: Tournament #3632677041, $0.23+$0.02 USD Hold'em No Limit - Level XII (500/1000) - 2023/08/17 19:31:47 AT [2023/08/17 18:31:47 ET]
Table '3632677041 4' 9-max Seat #7 is the button
Seat 2: Vinteseis36 (11056 in chips) 
Seat 4: fmorandi (22532 in chips) 
Seat 5: Caio Mugarte (17599 in chips) 
Seat 7: rebeLoNrun (8384 in chips) 
Seat 8: SOY PATO355 (7929 in chips) 
Vinteseis36: posts the ante 60
fmorandi: posts the ante 60
Caio Mugarte: posts the ante 60
rebeLoNrun: posts the ante 60
SOY PATO355: posts the ante 60
SOY PATO355: posts small blind 500
Vinteseis36: posts big blind 1000
*** HOLE CARDS ***
Dealt to Caio Mugarte [Kd 2c]
fmorandi: calls 1000
Caio Mugarte: folds 
rebeLoNrun: folds 
SOY PATO355: calls 500
Vinteseis36: checks 
*** FLOP *** [Jd 4c 8c]
SOY PATO355: checks 
Vinteseis36: checks 
fmorandi: bets 1650
SOY PATO355: folds 
Vinteseis36: folds 
Uncalled bet (1650) returned to fmorandi
fmorandi collected 3300 from pot
*** SUMMARY ***
Total pot 3300 | Rake 0 
Board [Jd 4c 8c]
Seat 2: Vinteseis36 (big blind) folded on the Flop
Seat 4: fmorandi collected (3300)
Seat 5: Caio Mugarte folded before Flop (didn't bet)
Seat 7: rebeLoNrun (button) folded before Flop (didn't bet)
Seat 8: SOY PATO355 (small blind) folded on the Flop



PokerStars Hand #245448705301: Tournament #3632677041, $0.23+$0.02 USD Hold'em No Limit - Level XII (500/1000) - 2023/08/17 19:32:26 AT [2023/08/17 18:32:26 ET]
Table '3632677041 4' 9-max Seat #8 is the button
Seat 2: Vinteseis36 (9996 in chips) 
Seat 4: fmorandi (24772 in chips) 
Seat 5: Caio Mugarte (17539 in chips) 
Seat 7: rebeLoNrun (8324 in chips) 
Seat 8: SOY PATO355 (6869 in chips) 
Vinteseis36: posts the ante 60
fmorandi: posts the ante 60
Caio Mugarte: posts the ante 60
rebeLoNrun: posts the ante 60
SOY PATO355: posts the ante 60
Vinteseis36: posts small blind 500
fmorandi: posts big blind 1000
*** HOLE CARDS ***
Dealt to Caio Mugarte [Ks 2s]
Caio Mugarte: folds 
rebeLoNrun: folds 
SOY PATO355: folds 
Vinteseis36: folds 
Uncalled bet (500) returned to fmorandi
fmorandi collected 1300 from pot
*** SUMMARY ***
Total pot 1300 | Rake 0 
Seat 2: Vinteseis36 (small blind) folded before Flop
Seat 4: fmorandi (big blind) collected (1300)
Seat 5: Caio Mugarte folded before Flop (didn't bet)
Seat 7: rebeLoNrun folded before Flop (didn't bet)
Seat 8: SOY PATO355 (button) folded before Flop (didn't bet)



PokerStars Hand #245448708064: Tournament #3632677041, $0.23+$0.02 USD Hold'em No Limit - Level XII (500/1000) - 2023/08/17 19:32:36 AT [2023/08/17 18:32:36 ET]
Table '3632677041 4' 9-max Seat #2 is the button
Seat 2: Vinteseis36 (9436 in chips) 
Seat 4: fmorandi (25512 in chips) 
Seat 5: Caio Mugarte (17479 in chips) 
Seat 7: rebeLoNrun (8264 in chips) 
Seat 8: SOY PATO355 (6809 in chips) 
Vinteseis36: posts the ante 60
fmorandi: posts the ante 60
Caio Mugarte: posts the ante 60
rebeLoNrun: posts the ante 60
SOY PATO355: posts the ante 60
fmorandi: posts small blind 500
Caio Mugarte: posts big blind 1000
*** HOLE CARDS ***
Dealt to Caio Mugarte [Qs Ts]
rebeLoNrun: folds 
SOY PATO355: raises 5749 to 6749 and is all-in
Vinteseis36: calls 6749
fmorandi: folds 
Caio Mugarte: folds 
*** FLOP *** [Ac 4d 4s]
*** TURN *** [Ac 4d 4s] [5c]
*** RIVER *** [Ac 4d 4s 5c] [6c]
*** SHOW DOWN ***
SOY PATO355: shows [As 6d] (two pair, Aces and Sixes)
Vinteseis36: shows [Tc Th] (two pair, Tens and Fours)
SOY PATO355 collected 15298 from pot
*** SUMMARY ***
Total pot 15298 | Rake 0 
Board [Ac 4d 4s 5c 6c]
Seat 2: Vinteseis36 (button) showed [Tc Th] and lost with two pair, Tens and Fours
Seat 4: fmorandi (small blind) folded before Flop
Seat 5: Caio Mugarte (big blind) folded before Flop
Seat 7: rebeLoNrun folded before Flop (didn't bet)
Seat 8: SOY PATO355 showed [As 6d] and won (15298) with two pair, Aces and Sixes



PokerStars Hand #245448713906: Tournament #3632677041, $0.23+$0.02 USD Hold'em No Limit - Level XII (500/1000) - 2023/08/17 19:32:56 AT [2023/08/17 18:32:56 ET]
Table '3632677041 4' 9-max Seat #4 is the button
Seat 2: Vinteseis36 (2627 in chips) 
Seat 4: fmorandi (24952 in chips) 
Seat 5: Caio Mugarte (16419 in chips) 
Seat 7: rebeLoNrun (8204 in chips) 
Seat 8: SOY PATO355 (15298 in chips) 
Vinteseis36: posts the ante 60
fmorandi: posts the ante 60
Caio Mugarte: posts the ante 60
rebeLoNrun: posts the ante 60
SOY PATO355: posts the ante 60
Caio Mugarte: posts small blind 500
rebeLoNrun: posts big blind 1000
*** HOLE CARDS ***
Dealt to Caio Mugarte [Ks 7c]
SOY PATO355: folds 
Vinteseis36: folds 
fmorandi: folds 
Caio Mugarte: raises 2500 to 3500
rebeLoNrun: folds 
Uncalled bet (2500) returned to Caio Mugarte
Caio Mugarte collected 2300 from pot
Caio Mugarte: doesn't show hand 
*** SUMMARY ***
Total pot 2300 | Rake 0 
Seat 2: Vinteseis36 folded before Flop (didn't bet)
Seat 4: fmorandi (button) folded before Flop (didn't bet)
Seat 5: Caio Mugarte (small blind) collected (2300)
Seat 7: rebeLoNrun (big blind) folded before Flop
Seat 8: SOY PATO355 folded before Flop (didn't bet)



PokerStars Hand #245448717389: Tournament #3632677041, $0.23+$0.02 USD Hold'em No Limit - Level XII (500/1000) - 2023/08/17 19:33:08 AT [2023/08/17 18:33:08 ET]
Table '3632677041 4' 9-max Seat #5 is the button
Seat 2: Vinteseis36 (2567 in chips) 
Seat 4: fmorandi (24892 in chips) 
Seat 5: Caio Mugarte (17659 in chips) 
Seat 7: rebeLoNrun (7144 in chips) 
Seat 8: SOY PATO355 (15238 in chips) 
Vinteseis36: posts the ante 60
fmorandi: posts the ante 60
Caio Mugarte: posts the ante 60
rebeLoNrun: posts the ante 60
SOY PATO355: posts the ante 60
rebeLoNrun: posts small blind 500
SOY PATO355: posts big blind 1000
*** HOLE CARDS ***
Dealt to Caio Mugarte [7h 7c]
Vinteseis36: folds 
fmorandi: folds 
Caio Mugarte: raises 1000 to 2000
rebeLoNrun: folds 
SOY PATO355: folds 
Uncalled bet (1000) returned to Caio Mugarte
Caio Mugarte collected 2800 from pot
Caio Mugarte: doesn't show hand 
*** SUMMARY ***
Total pot 2800 | Rake 0 
Seat 2: Vinteseis36 folded before Flop (didn't bet)
Seat 4: fmorandi folded before Flop (didn't bet)
Seat 5: Caio Mugarte (button) collected (2800)
Seat 7: rebeLoNrun (small blind) folded before Flop
Seat 8: SOY PATO355 (big blind) folded before Flop



PokerStars Hand #245448720438: Tournament #3632677041, $0.23+$0.02 USD Hold'em No Limit - Level XII (500/1000) - 2023/08/17 19:33:19 AT [2023/08/17 18:33:19 ET]
Table '3632677041 4' 9-max Seat #7 is the button
Seat 2: Vinteseis36 (2507 in chips) 
Seat 4: fmorandi (24832 in chips) 
Seat 5: Caio Mugarte (19399 in chips) 
Seat 7: rebeLoNrun (6584 in chips) 
Seat 8: SOY PATO355 (14178 in chips) 
Vinteseis36: posts the ante 60
fmorandi: posts the ante 60
Caio Mugarte: posts the ante 60
rebeLoNrun: posts the ante 60
SOY PATO355: posts the ante 60
SOY PATO355: posts small blind 500
Vinteseis36: posts big blind 1000
*** HOLE CARDS ***
Dealt to Caio Mugarte [As 5s]
fmorandi: folds 
Caio Mugarte: raises 1000 to 2000
rebeLoNrun: folds 
SOY PATO355: folds 
Vinteseis36: folds 
Uncalled bet (1000) returned to Caio Mugarte
Caio Mugarte collected 2800 from pot
Caio Mugarte: doesn't show hand 
*** SUMMARY ***
Total pot 2800 | Rake 0 
Seat 2: Vinteseis36 (big blind) folded before Flop
Seat 4: fmorandi folded before Flop (didn't bet)
Seat 5: Caio Mugarte collected (2800)
Seat 7: rebeLoNrun (button) folded before Flop (didn't bet)
Seat 8: SOY PATO355 (small blind) folded before Flop



PokerStars Hand #245448724756: Tournament #3632677041, $0.23+$0.02 USD Hold'em No Limit - Level XII (500/1000) - 2023/08/17 19:33:34 AT [2023/08/17 18:33:34 ET]
Table '3632677041 4' 9-max Seat #8 is the button
Seat 2: Vinteseis36 (1447 in chips) 
Seat 4: fmorandi (24772 in chips) 
Seat 5: Caio Mugarte (21139 in chips) 
Seat 7: rebeLoNrun (6524 in chips) 
Seat 8: SOY PATO355 (13618 in chips) 
Vinteseis36: posts the ante 60
fmorandi: posts the ante 60
Caio Mugarte: posts the ante 60
rebeLoNrun: posts the ante 60
SOY PATO355: posts the ante 60
Vinteseis36: posts small blind 500
fmorandi: posts big blind 1000
*** HOLE CARDS ***
Dealt to Caio Mugarte [6c 7h]
Caio Mugarte: folds 
rebeLoNrun: folds 
SOY PATO355: raises 1000 to 2000
Vinteseis36: calls 887 and is all-in
fmorandi: calls 1000
*** FLOP *** [4d Qh 9s]
fmorandi: bets 2000
SOY PATO355: calls 2000
*** TURN *** [4d Qh 9s] [8h]
fmorandi: bets 4844
SOY PATO355: folds 
Uncalled bet (4844) returned to fmorandi
*** RIVER *** [4d Qh 9s 8h] [9c]
*** SHOW DOWN ***
fmorandi: shows [Qc 5d] (two pair, Queens and Nines)
fmorandi collected 5226 from side pot
Vinteseis36: shows [8c Tc] (two pair, Nines and Eights)
fmorandi collected 4461 from main pot
Vinteseis36 finished the tournament in 5th place and received $0.86.
*** SUMMARY ***
Total pot 9687 Main pot 4461. Side pot 5226. | Rake 0 
Board [4d Qh 9s 8h 9c]
Seat 2: Vinteseis36 (small blind) showed [8c Tc] and lost with two pair, Nines and Eights
Seat 4: fmorandi (big blind) showed [Qc 5d] and won (9687) with two pair, Queens and Nines
Seat 5: Caio Mugarte folded before Flop (didn't bet)
Seat 7: rebeLoNrun folded before Flop (didn't bet)
Seat 8: SOY PATO355 (button) folded on the Turn



PokerStars Hand #245448734359: Tournament #3632677041, $0.23+$0.02 USD Hold'em No Limit - Level XII (500/1000) - 2023/08/17 19:34:08 AT [2023/08/17 18:34:08 ET]
Table '3632677041 4' 9-max Seat #4 is the button
Seat 4: fmorandi (30399 in chips) 
Seat 5: Caio Mugarte (21079 in chips) 
Seat 7: rebeLoNrun (6464 in chips) 
Seat 8: SOY PATO355 (9558 in chips) 
fmorandi: posts the ante 60
Caio Mugarte: posts the ante 60
rebeLoNrun: posts the ante 60
SOY PATO355: posts the ante 60
Caio Mugarte: posts small blind 500
rebeLoNrun: posts big blind 1000
*** HOLE CARDS ***
Dealt to Caio Mugarte [6h 5d]
SOY PATO355: raises 1000 to 2000
fmorandi: calls 2000
Caio Mugarte: folds 
rebeLoNrun: folds 
*** FLOP *** [9d Kd 5c]
SOY PATO355: checks 
fmorandi: checks 
*** TURN *** [9d Kd 5c] [3c]
SOY PATO355: checks 
fmorandi: checks 
*** RIVER *** [9d Kd 5c 3c] [As]
SOY PATO355: checks 
fmorandi: checks 
*** SHOW DOWN ***
SOY PATO355: shows [6d Ah] (a pair of Aces)
fmorandi: mucks hand 
SOY PATO355 collected 5740 from pot
*** SUMMARY ***
Total pot 5740 | Rake 0 
Board [9d Kd 5c 3c As]
Seat 4: fmorandi (button) mucked [Th Qc]
Seat 5: Caio Mugarte (small blind) folded before Flop
Seat 7: rebeLoNrun (big blind) folded before Flop
Seat 8: SOY PATO355 showed [6d Ah] and won (5740) with a pair of Aces



PokerStars Hand #245448740811: Tournament #3632677041, $0.23+$0.02 USD Hold'em No Limit - Level XII (500/1000) - 2023/08/17 19:34:30 AT [2023/08/17 18:34:30 ET]
Table '3632677041 4' 9-max Seat #5 is the button
Seat 4: fmorandi (28339 in chips) 
Seat 5: Caio Mugarte (20519 in chips) 
Seat 7: rebeLoNrun (5404 in chips) 
Seat 8: SOY PATO355 (13238 in chips) 
fmorandi: posts the ante 60
Caio Mugarte: posts the ante 60
rebeLoNrun: posts the ante 60
SOY PATO355: posts the ante 60
rebeLoNrun: posts small blind 500
SOY PATO355: posts big blind 1000
*** HOLE CARDS ***
Dealt to Caio Mugarte [Kc Kd]
fmorandi: folds 
Caio Mugarte: raises 1000 to 2000
rebeLoNrun: folds 
SOY PATO355: folds 
Uncalled bet (1000) returned to Caio Mugarte
Caio Mugarte collected 2740 from pot
Caio Mugarte: doesn't show hand 
*** SUMMARY ***
Total pot 2740 | Rake 0 
Seat 4: fmorandi folded before Flop (didn't bet)
Seat 5: Caio Mugarte (button) collected (2740)
Seat 7: rebeLoNrun (small blind) folded before Flop
Seat 8: SOY PATO355 (big blind) folded before Flop



PokerStars Hand #245448745471: Tournament #3632677041, $0.23+$0.02 USD Hold'em No Limit - Level XII (500/1000) - 2023/08/17 19:34:47 AT [2023/08/17 18:34:47 ET]
Table '3632677041 4' 9-max Seat #7 is the button
Seat 4: fmorandi (28279 in chips) 
Seat 5: Caio Mugarte (22199 in chips) 
Seat 7: rebeLoNrun (4844 in chips) 
Seat 8: SOY PATO355 (12178 in chips) 
fmorandi: posts the ante 60
Caio Mugarte: posts the ante 60
rebeLoNrun: posts the ante 60
SOY PATO355: posts the ante 60
SOY PATO355: posts small blind 500
fmorandi: posts big blind 1000
*** HOLE CARDS ***
Dealt to Caio Mugarte [Tc 9h]
Caio Mugarte: raises 1000 to 2000
rebeLoNrun: raises 2784 to 4784 and is all-in
SOY PATO355: folds 
fmorandi: folds 
Caio Mugarte: calls 2784
*** FLOP *** [2d 4s 4h]
*** TURN *** [2d 4s 4h] [Qd]
*** RIVER *** [2d 4s 4h Qd] [3h]
*** SHOW DOWN ***
Caio Mugarte: shows [Tc 9h] (a pair of Fours)
rebeLoNrun: shows [Qh As] (two pair, Queens and Fours)
rebeLoNrun collected 11308 from pot
*** SUMMARY ***
Total pot 11308 | Rake 0 
Board [2d 4s 4h Qd 3h]
Seat 4: fmorandi (big blind) folded before Flop
Seat 5: Caio Mugarte showed [Tc 9h] and lost with a pair of Fours
Seat 7: rebeLoNrun (button) showed [Qh As] and won (11308) with two pair, Queens and Fours
Seat 8: SOY PATO355 (small blind) folded before Flop



PokerStars Hand #245448751642: Tournament #3632677041, $0.23+$0.02 USD Hold'em No Limit - Level XII (500/1000) - 2023/08/17 19:35:08 AT [2023/08/17 18:35:08 ET]
Table '3632677041 4' 9-max Seat #8 is the button
Seat 4: fmorandi (27219 in chips) 
Seat 5: Caio Mugarte (17355 in chips) 
Seat 7: rebeLoNrun (11308 in chips) 
Seat 8: SOY PATO355 (11618 in chips) 
fmorandi: posts the ante 60
Caio Mugarte: posts the ante 60
rebeLoNrun: posts the ante 60
SOY PATO355: posts the ante 60
fmorandi: posts small blind 500
Caio Mugarte: posts big blind 1000
*** HOLE CARDS ***
Dealt to Caio Mugarte [Ah 2s]
rebeLoNrun: folds 
SOY PATO355: folds 
fmorandi: calls 500
Caio Mugarte: checks 
*** FLOP *** [6s Ad 3c]
fmorandi: checks 
Caio Mugarte: bets 1000
fmorandi: folds 
Uncalled bet (1000) returned to Caio Mugarte
Caio Mugarte collected 2240 from pot
Caio Mugarte: doesn't show hand 
*** SUMMARY ***
Total pot 2240 | Rake 0 
Board [6s Ad 3c]
Seat 4: fmorandi (small blind) folded on the Flop
Seat 5: Caio Mugarte (big blind) collected (2240)
Seat 7: rebeLoNrun folded before Flop (didn't bet)
Seat 8: SOY PATO355 (button) folded before Flop (didn't bet)



PokerStars Hand #245448756969: Tournament #3632677041, $0.23+$0.02 USD Hold'em No Limit - Level XIII (600/1200) - 2023/08/17 19:35:27 AT [2023/08/17 18:35:27 ET]
Table '3632677041 4' 9-max Seat #4 is the button
Seat 4: fmorandi (26159 in chips) 
Seat 5: Caio Mugarte (18535 in chips) 
Seat 7: rebeLoNrun (11248 in chips) 
Seat 8: SOY PATO355 (11558 in chips) 
fmorandi: posts the ante 75
Caio Mugarte: posts the ante 75
rebeLoNrun: posts the ante 75
SOY PATO355: posts the ante 75
Caio Mugarte: posts small blind 600
rebeLoNrun: posts big blind 1200
*** HOLE CARDS ***
Dealt to Caio Mugarte [Ad As]
SOY PATO355: folds 
fmorandi: raises 1200 to 2400
Caio Mugarte: raises 16060 to 18460 and is all-in
rebeLoNrun: folds 
fmorandi: folds 
Uncalled bet (16060) returned to Caio Mugarte
Caio Mugarte collected 6300 from pot
Caio Mugarte: doesn't show hand 
*** SUMMARY ***
Total pot 6300 | Rake 0 
Seat 4: fmorandi (button) folded before Flop
Seat 5: Caio Mugarte (small blind) collected (6300)
Seat 7: rebeLoNrun (big blind) folded before Flop
Seat 8: SOY PATO355 folded before Flop (didn't bet)



PokerStars Hand #245448762236: Tournament #3632677041, $0.23+$0.02 USD Hold'em No Limit - Level XIII (600/1200) - 2023/08/17 19:35:45 AT [2023/08/17 18:35:45 ET]
Table '3632677041 4' 9-max Seat #5 is the button
Seat 4: fmorandi (23684 in chips) 
Seat 5: Caio Mugarte (22360 in chips) 
Seat 7: rebeLoNrun (9973 in chips) 
Seat 8: SOY PATO355 (11483 in chips) 
fmorandi: posts the ante 75
Caio Mugarte: posts the ante 75
rebeLoNrun: posts the ante 75
SOY PATO355: posts the ante 75
rebeLoNrun: posts small blind 600
SOY PATO355: posts big blind 1200
*** HOLE CARDS ***
Dealt to Caio Mugarte [Td 2d]
fmorandi: folds 
Caio Mugarte: folds 
rebeLoNrun: folds 
Uncalled bet (600) returned to SOY PATO355
SOY PATO355 collected 1500 from pot
SOY PATO355: doesn't show hand 
*** SUMMARY ***
Total pot 1500 | Rake 0 
Seat 4: fmorandi folded before Flop (didn't bet)
Seat 5: Caio Mugarte (button) folded before Flop (didn't bet)
Seat 7: rebeLoNrun (small blind) folded before Flop
Seat 8: SOY PATO355 (big blind) collected (1500)



PokerStars Hand #245448764165: Tournament #3632677041, $0.23+$0.02 USD Hold'em No Limit - Level XIII (600/1200) - 2023/08/17 19:35:52 AT [2023/08/17 18:35:52 ET]
Table '3632677041 4' 9-max Seat #7 is the button
Seat 4: fmorandi (23609 in chips) 
Seat 5: Caio Mugarte (22285 in chips) 
Seat 7: rebeLoNrun (9298 in chips) 
Seat 8: SOY PATO355 (12308 in chips) 
fmorandi: posts the ante 75
Caio Mugarte: posts the ante 75
rebeLoNrun: posts the ante 75
SOY PATO355: posts the ante 75
SOY PATO355: posts small blind 600
fmorandi: posts big blind 1200
*** HOLE CARDS ***
Dealt to Caio Mugarte [5d 3h]
Caio Mugarte: folds 
rebeLoNrun: folds 
SOY PATO355: calls 600
fmorandi: checks 
*** FLOP *** [Jh Th 2d]
SOY PATO355: checks 
fmorandi: checks 
*** TURN *** [Jh Th 2d] [2c]
SOY PATO355: bets 1200
fmorandi: calls 1200
*** RIVER *** [Jh Th 2d 2c] [7d]
SOY PATO355: bets 2400
fmorandi: raises 2400 to 4800
SOY PATO355: folds 
Uncalled bet (2400) returned to fmorandi
fmorandi collected 9900 from pot
*** SUMMARY ***
Total pot 9900 | Rake 0 
Board [Jh Th 2d 2c 7d]
Seat 4: fmorandi (big blind) collected (9900)
Seat 5: Caio Mugarte folded before Flop (didn't bet)
Seat 7: rebeLoNrun (button) folded before Flop (didn't bet)
Seat 8: SOY PATO355 (small blind) folded on the River



PokerStars Hand #245448772622: Tournament #3632677041, $0.23+$0.02 USD Hold'em No Limit - Level XIII (600/1200) - 2023/08/17 19:36:21 AT [2023/08/17 18:36:21 ET]
Table '3632677041 4' 9-max Seat #8 is the button
Seat 4: fmorandi (28634 in chips) 
Seat 5: Caio Mugarte (22210 in chips) 
Seat 7: rebeLoNrun (9223 in chips) 
Seat 8: SOY PATO355 (7433 in chips) 
fmorandi: posts the ante 75
Caio Mugarte: posts the ante 75
rebeLoNrun: posts the ante 75
SOY PATO355: posts the ante 75
fmorandi: posts small blind 600
Caio Mugarte: posts big blind 1200
*** HOLE CARDS ***
Dealt to Caio Mugarte [Kc 9d]
rebeLoNrun: folds 
SOY PATO355: folds 
fmorandi: calls 600
Caio Mugarte: checks 
*** FLOP *** [3d 9h 5s]
fmorandi: checks 
Caio Mugarte: bets 1200
fmorandi: calls 1200
*** TURN *** [3d 9h 5s] [2c]
fmorandi: bets 2550
Caio Mugarte: calls 2550
*** RIVER *** [3d 9h 5s 2c] [8d]
fmorandi: bets 10200
Caio Mugarte: folds 
Uncalled bet (10200) returned to fmorandi
fmorandi collected 10200 from pot
*** SUMMARY ***
Total pot 10200 | Rake 0 
Board [3d 9h 5s 2c 8d]
Seat 4: fmorandi (small blind) collected (10200)
Seat 5: Caio Mugarte (big blind) folded on the River
Seat 7: rebeLoNrun folded before Flop (didn't bet)
Seat 8: SOY PATO355 (button) folded before Flop (didn't bet)



PokerStars Hand #245448784450: Tournament #3632677041, $0.23+$0.02 USD Hold'em No Limit - Level XIII (600/1200) - 2023/08/17 19:37:02 AT [2023/08/17 18:37:02 ET]
Table '3632677041 4' 9-max Seat #4 is the button
Seat 4: fmorandi (33809 in chips) 
Seat 5: Caio Mugarte (17185 in chips) 
Seat 7: rebeLoNrun (9148 in chips) 
Seat 8: SOY PATO355 (7358 in chips) 
fmorandi: posts the ante 75
Caio Mugarte: posts the ante 75
rebeLoNrun: posts the ante 75
SOY PATO355: posts the ante 75
Caio Mugarte: posts small blind 600
rebeLoNrun: posts big blind 1200
*** HOLE CARDS ***
Dealt to Caio Mugarte [8s Qc]
SOY PATO355: folds 
fmorandi: folds 
Caio Mugarte: raises 3000 to 4200
rebeLoNrun: folds 
Uncalled bet (3000) returned to Caio Mugarte
Caio Mugarte collected 2700 from pot
Caio Mugarte: doesn't show hand 
*** SUMMARY ***
Total pot 2700 | Rake 0 
Seat 4: fmorandi (button) folded before Flop (didn't bet)
Seat 5: Caio Mugarte (small blind) collected (2700)
Seat 7: rebeLoNrun (big blind) folded before Flop
Seat 8: SOY PATO355 folded before Flop (didn't bet)



PokerStars Hand #245448789420: Tournament #3632677041, $0.23+$0.02 USD Hold'em No Limit - Level XIII (600/1200) - 2023/08/17 19:37:20 AT [2023/08/17 18:37:20 ET]
Table '3632677041 4' 9-max Seat #5 is the button
Seat 4: fmorandi (33734 in chips) 
Seat 5: Caio Mugarte (18610 in chips) 
Seat 7: rebeLoNrun (7873 in chips) 
Seat 8: SOY PATO355 (7283 in chips) 
fmorandi: posts the ante 75
Caio Mugarte: posts the ante 75
rebeLoNrun: posts the ante 75
SOY PATO355: posts the ante 75
rebeLoNrun: posts small blind 600
SOY PATO355: posts big blind 1200
*** HOLE CARDS ***
Dealt to Caio Mugarte [8c 5h]
fmorandi: calls 1200
Caio Mugarte: folds 
rebeLoNrun: folds 
SOY PATO355: checks 
*** FLOP *** [3d 8s Jh]
SOY PATO355: checks 
fmorandi: checks 
*** TURN *** [3d 8s Jh] [6c]
SOY PATO355: checks 
fmorandi: bets 1200
SOY PATO355: folds 
Uncalled bet (1200) returned to fmorandi
fmorandi collected 3300 from pot
*** SUMMARY ***
Total pot 3300 | Rake 0 
Board [3d 8s Jh 6c]
Seat 4: fmorandi collected (3300)
Seat 5: Caio Mugarte (button) folded before Flop (didn't bet)
Seat 7: rebeLoNrun (small blind) folded before Flop
Seat 8: SOY PATO355 (big blind) folded on the Turn



PokerStars Hand #245448797894: Tournament #3632677041, $0.23+$0.02 USD Hold'em No Limit - Level XIII (600/1200) - 2023/08/17 19:37:50 AT [2023/08/17 18:37:50 ET]
Table '3632677041 4' 9-max Seat #7 is the button
Seat 4: fmorandi (35759 in chips) 
Seat 5: Caio Mugarte (18535 in chips) 
Seat 7: rebeLoNrun (7198 in chips) 
Seat 8: SOY PATO355 (6008 in chips) 
fmorandi: posts the ante 75
Caio Mugarte: posts the ante 75
rebeLoNrun: posts the ante 75
SOY PATO355: posts the ante 75
SOY PATO355: posts small blind 600
fmorandi: posts big blind 1200
*** HOLE CARDS ***
Dealt to Caio Mugarte [5d Qs]
Caio Mugarte: folds 
rebeLoNrun: folds 
SOY PATO355: raises 4733 to 5933 and is all-in
fmorandi: folds 
Uncalled bet (4733) returned to SOY PATO355
SOY PATO355 collected 2700 from pot
SOY PATO355: doesn't show hand 
*** SUMMARY ***
Total pot 2700 | Rake 0 
Seat 4: fmorandi (big blind) folded before Flop
Seat 5: Caio Mugarte folded before Flop (didn't bet)
Seat 7: rebeLoNrun (button) folded before Flop (didn't bet)
Seat 8: SOY PATO355 (small blind) collected (2700)



PokerStars Hand #245448803342: Tournament #3632677041, $0.23+$0.02 USD Hold'em No Limit - Level XIII (600/1200) - 2023/08/17 19:38:09 AT [2023/08/17 18:38:09 ET]
Table '3632677041 4' 9-max Seat #8 is the button
Seat 4: fmorandi (34484 in chips) 
Seat 5: Caio Mugarte (18460 in chips) 
Seat 7: rebeLoNrun (7123 in chips) 
Seat 8: SOY PATO355 (7433 in chips) 
fmorandi: posts the ante 75
Caio Mugarte: posts the ante 75
rebeLoNrun: posts the ante 75
SOY PATO355: posts the ante 75
fmorandi: posts small blind 600
Caio Mugarte: posts big blind 1200
*** HOLE CARDS ***
Dealt to Caio Mugarte [8h 8s]
rebeLoNrun: folds 
SOY PATO355: folds 
fmorandi: folds 
Uncalled bet (600) returned to Caio Mugarte
Caio Mugarte collected 1500 from pot
Caio Mugarte: doesn't show hand 
*** SUMMARY ***
Total pot 1500 | Rake 0 
Seat 4: fmorandi (small blind) folded before Flop
Seat 5: Caio Mugarte (big blind) collected (1500)
Seat 7: rebeLoNrun folded before Flop (didn't bet)
Seat 8: SOY PATO355 (button) folded before Flop (didn't bet)



PokerStars Hand #245448805853: Tournament #3632677041, $0.23+$0.02 USD Hold'em No Limit - Level XIII (600/1200) - 2023/08/17 19:38:17 AT [2023/08/17 18:38:17 ET]
Table '3632677041 4' 9-max Seat #4 is the button
Seat 4: fmorandi (33809 in chips) 
Seat 5: Caio Mugarte (19285 in chips) 
Seat 7: rebeLoNrun (7048 in chips) 
Seat 8: SOY PATO355 (7358 in chips) 
fmorandi: posts the ante 75
Caio Mugarte: posts the ante 75
rebeLoNrun: posts the ante 75
SOY PATO355: posts the ante 75
Caio Mugarte: posts small blind 600
rebeLoNrun: posts big blind 1200
*** HOLE CARDS ***
Dealt to Caio Mugarte [5s Js]
SOY PATO355: folds 
fmorandi: folds 
Caio Mugarte: raises 18010 to 19210 and is all-in
rebeLoNrun: calls 5773 and is all-in
Uncalled bet (12237) returned to Caio Mugarte
*** FLOP *** [7d 4c 8d]
*** TURN *** [7d 4c 8d] [6d]
*** RIVER *** [7d 4c 8d 6d] [Qs]
*** SHOW DOWN ***
Caio Mugarte: shows [5s Js] (a straight, Four to Eight)
rebeLoNrun: shows [9h Jd] (high card Queen)
Caio Mugarte collected 14246 from pot
rebeLoNrun finished the tournament in 4th place and received $1.20.
*** SUMMARY ***
Total pot 14246 | Rake 0 
Board [7d 4c 8d 6d Qs]
Seat 4: fmorandi (button) folded before Flop (didn't bet)
Seat 5: Caio Mugarte (small blind) showed [5s Js] and won (14246) with a straight, Four to Eight
Seat 7: rebeLoNrun (big blind) showed [9h Jd] and lost with high card Queen
Seat 8: SOY PATO355 folded before Flop (didn't bet)



PokerStars Hand #245448810715: Tournament #3632677041, $0.23+$0.02 USD Hold'em No Limit - Level XIII (600/1200) - 2023/08/17 19:38:34 AT [2023/08/17 18:38:34 ET]
Table '3632677041 4' 9-max Seat #5 is the button
Seat 4: fmorandi (33734 in chips) 
Seat 5: Caio Mugarte (26483 in chips) 
Seat 8: SOY PATO355 (7283 in chips) 
fmorandi: posts the ante 75
Caio Mugarte: posts the ante 75
SOY PATO355: posts the ante 75
SOY PATO355: posts small blind 600
fmorandi: posts big blind 1200
*** HOLE CARDS ***
Dealt to Caio Mugarte [Jc Js]
Caio Mugarte: raises 1200 to 2400
SOY PATO355: folds 
fmorandi: folds 
Uncalled bet (1200) returned to Caio Mugarte
Caio Mugarte collected 3225 from pot
Caio Mugarte: doesn't show hand 
*** SUMMARY ***
Total pot 3225 | Rake 0 
Seat 4: fmorandi (big blind) folded before Flop
Seat 5: Caio Mugarte (button) collected (3225)
Seat 8: SOY PATO355 (small blind) folded before Flop



PokerStars Hand #245448813541: Tournament #3632677041, $0.23+$0.02 USD Hold'em No Limit - Level XIII (600/1200) - 2023/08/17 19:38:44 AT [2023/08/17 18:38:44 ET]
Table '3632677041 4' 9-max Seat #8 is the button
Seat 4: fmorandi (32459 in chips) 
Seat 5: Caio Mugarte (28433 in chips) 
Seat 8: SOY PATO355 (6608 in chips) 
fmorandi: posts the ante 75
Caio Mugarte: posts the ante 75
SOY PATO355: posts the ante 75
fmorandi: posts small blind 600
Caio Mugarte: posts big blind 1200
*** HOLE CARDS ***
Dealt to Caio Mugarte [3h 7h]
SOY PATO355: raises 5333 to 6533 and is all-in
fmorandi: folds 
Caio Mugarte: folds 
Uncalled bet (5333) returned to SOY PATO355
SOY PATO355 collected 3225 from pot
SOY PATO355: doesn't show hand 
*** SUMMARY ***
Total pot 3225 | Rake 0 
Seat 4: fmorandi (small blind) folded before Flop
Seat 5: Caio Mugarte (big blind) folded before Flop
Seat 8: SOY PATO355 (button) collected (3225)



PokerStars Hand #245448817935: Tournament #3632677041, $0.23+$0.02 USD Hold'em No Limit - Level XIII (600/1200) - 2023/08/17 19:38:59 AT [2023/08/17 18:38:59 ET]
Table '3632677041 4' 9-max Seat #4 is the button
Seat 4: fmorandi (31784 in chips) 
Seat 5: Caio Mugarte (27158 in chips) 
Seat 8: SOY PATO355 (8558 in chips) 
fmorandi: posts the ante 75
Caio Mugarte: posts the ante 75
SOY PATO355: posts the ante 75
Caio Mugarte: posts small blind 600
SOY PATO355: posts big blind 1200
*** HOLE CARDS ***
Dealt to Caio Mugarte [5h 4d]
fmorandi: raises 1200 to 2400
Caio Mugarte: folds 
SOY PATO355: folds 
Uncalled bet (1200) returned to fmorandi
fmorandi collected 3225 from pot
*** SUMMARY ***
Total pot 3225 | Rake 0 
Seat 4: fmorandi (button) collected (3225)
Seat 5: Caio Mugarte (small blind) folded before Flop
Seat 8: SOY PATO355 (big blind) folded before Flop



PokerStars Hand #245448821263: Tournament #3632677041, $0.23+$0.02 USD Hold'em No Limit - Level XIII (600/1200) - 2023/08/17 19:39:11 AT [2023/08/17 18:39:11 ET]
Table '3632677041 4' 9-max Seat #5 is the button
Seat 4: fmorandi (33734 in chips) 
Seat 5: Caio Mugarte (26483 in chips) 
Seat 8: SOY PATO355 (7283 in chips) 
fmorandi: posts the ante 75
Caio Mugarte: posts the ante 75
SOY PATO355: posts the ante 75
SOY PATO355: posts small blind 600
fmorandi: posts big blind 1200
*** HOLE CARDS ***
Dealt to Caio Mugarte [Jc 3d]
Caio Mugarte: folds 
SOY PATO355: raises 6008 to 7208 and is all-in
fmorandi: folds 
Uncalled bet (6008) returned to SOY PATO355
SOY PATO355 collected 2625 from pot
SOY PATO355: doesn't show hand 
*** SUMMARY ***
Total pot 2625 | Rake 0 
Seat 4: fmorandi (big blind) folded before Flop
Seat 5: Caio Mugarte (button) folded before Flop (didn't bet)
Seat 8: SOY PATO355 (small blind) collected (2625)



PokerStars Hand #245448825021: Tournament #3632677041, $0.23+$0.02 USD Hold'em No Limit - Level XIII (600/1200) - 2023/08/17 19:39:24 AT [2023/08/17 18:39:24 ET]
Table '3632677041 4' 9-max Seat #8 is the button
Seat 4: fmorandi (32459 in chips) 
Seat 5: Caio Mugarte (26408 in chips) 
Seat 8: SOY PATO355 (8633 in chips) 
fmorandi: posts the ante 75
Caio Mugarte: posts the ante 75
SOY PATO355: posts the ante 75
fmorandi: posts small blind 600
Caio Mugarte: posts big blind 1200
*** HOLE CARDS ***
Dealt to Caio Mugarte [9h 6h]
SOY PATO355: folds 
fmorandi: folds 
Uncalled bet (600) returned to Caio Mugarte
Caio Mugarte collected 1425 from pot
Caio Mugarte: doesn't show hand 
*** SUMMARY ***
Total pot 1425 | Rake 0 
Seat 4: fmorandi (small blind) folded before Flop
Seat 5: Caio Mugarte (big blind) collected (1425)
Seat 8: SOY PATO355 (button) folded before Flop (didn't bet)



PokerStars Hand #245448827196: Tournament #3632677041, $0.23+$0.02 USD Hold'em No Limit - Level XIII (600/1200) - 2023/08/17 19:39:32 AT [2023/08/17 18:39:32 ET]
Table '3632677041 4' 9-max Seat #4 is the button
Seat 4: fmorandi (31784 in chips) 
Seat 5: Caio Mugarte (27158 in chips) 
Seat 8: SOY PATO355 (8558 in chips) 
fmorandi: posts the ante 75
Caio Mugarte: posts the ante 75
SOY PATO355: posts the ante 75
Caio Mugarte: posts small blind 600
SOY PATO355: posts big blind 1200
*** HOLE CARDS ***
Dealt to Caio Mugarte [2d As]
fmorandi: raises 1200 to 2400
Caio Mugarte: folds 
SOY PATO355: calls 1200
*** FLOP *** [7c 3s 9c]
SOY PATO355: checks 
fmorandi: bets 2400
SOY PATO355: raises 3683 to 6083 and is all-in
fmorandi: calls 3683
*** TURN *** [7c 3s 9c] [Ts]
*** RIVER *** [7c 3s 9c Ts] [9h]
*** SHOW DOWN ***
SOY PATO355: shows [5s 6s] (a pair of Nines)
fmorandi: shows [Th Qd] (two pair, Tens and Nines)
fmorandi collected 17791 from pot
SOY PATO355 finished the tournament in 3rd place and received $1.67.
*** SUMMARY ***
Total pot 17791 | Rake 0 
Board [7c 3s 9c Ts 9h]
Seat 4: fmorandi (button) showed [Th Qd] and won (17791) with two pair, Tens and Nines
Seat 5: Caio Mugarte (small blind) folded before Flop
Seat 8: SOY PATO355 (big blind) showed [5s 6s] and lost with a pair of Nines



PokerStars Hand #245448836466: Tournament #3632677041, $0.23+$0.02 USD Hold'em No Limit - Level XIII (600/1200) - 2023/08/17 19:40:04 AT [2023/08/17 18:40:04 ET]
Table '3632677041 4' 9-max Seat #5 is the button
Seat 4: fmorandi (41017 in chips) 
Seat 5: Caio Mugarte (26483 in chips) 
fmorandi: posts the ante 75
Caio Mugarte: posts the ante 75
Caio Mugarte: posts small blind 600
fmorandi: posts big blind 1200
*** HOLE CARDS ***
Dealt to Caio Mugarte [8d Jd]
Caio Mugarte: raises 2400 to 3600
fmorandi: folds 
Uncalled bet (2400) returned to Caio Mugarte
Caio Mugarte collected 2550 from pot
Caio Mugarte: doesn't show hand 
*** SUMMARY ***
Total pot 2550 | Rake 0 
Seat 4: fmorandi (big blind) folded before Flop
Seat 5: Caio Mugarte (button) (small blind) collected (2550)



PokerStars Hand #245448839904: Tournament #3632677041, $0.23+$0.02 USD Hold'em No Limit - Level XIII (600/1200) - 2023/08/17 19:40:16 AT [2023/08/17 18:40:16 ET]
Table '3632677041 4' 9-max Seat #4 is the button
Seat 4: fmorandi (39742 in chips) 
Seat 5: Caio Mugarte (27758 in chips) 
fmorandi: posts the ante 75
Caio Mugarte: posts the ante 75
fmorandi: posts small blind 600
Caio Mugarte: posts big blind 1200
*** HOLE CARDS ***
Dealt to Caio Mugarte [Ad Ac]
fmorandi: calls 600
Caio Mugarte: raises 2400 to 3600
fmorandi: folds 
Uncalled bet (2400) returned to Caio Mugarte
Caio Mugarte collected 2550 from pot
Caio Mugarte: doesn't show hand 
*** SUMMARY ***
Total pot 2550 | Rake 0 
Seat 4: fmorandi (button) (small blind) folded before Flop
Seat 5: Caio Mugarte (big blind) collected (2550)



PokerStars Hand #245448843708: Tournament #3632677041, $0.23+$0.02 USD Hold'em No Limit - Level XIII (600/1200) - 2023/08/17 19:40:30 AT [2023/08/17 18:40:30 ET]
Table '3632677041 4' 9-max Seat #5 is the button
Seat 4: fmorandi (38467 in chips) 
Seat 5: Caio Mugarte (29033 in chips) 
fmorandi: posts the ante 75
Caio Mugarte: posts the ante 75
Caio Mugarte: posts small blind 600
fmorandi: posts big blind 1200
*** HOLE CARDS ***
Dealt to Caio Mugarte [9c 7s]
Caio Mugarte: calls 600
fmorandi: checks 
*** FLOP *** [Jh Jd 7h]
fmorandi: checks 
Caio Mugarte: bets 1200
fmorandi: calls 1200
*** TURN *** [Jh Jd 7h] [3h]
fmorandi: checks 
Caio Mugarte: checks 
*** RIVER *** [Jh Jd 7h 3h] [Ts]
fmorandi: bets 4950
Caio Mugarte: calls 4950
*** SHOW DOWN ***
fmorandi: shows [Js 6c] (three of a kind, Jacks)
Caio Mugarte: mucks hand 
fmorandi collected 14850 from pot
*** SUMMARY ***
Total pot 14850 | Rake 0 
Board [Jh Jd 7h 3h Ts]
Seat 4: fmorandi (big blind) showed [Js 6c] and won (14850) with three of a kind, Jacks
Seat 5: Caio Mugarte (button) (small blind) mucked [9c 7s]



PokerStars Hand #245448854753: Tournament #3632677041, $0.23+$0.02 USD Hold'em No Limit - Level XIII (600/1200) - 2023/08/17 19:41:08 AT [2023/08/17 18:41:08 ET]
Table '3632677041 4' 9-max Seat #4 is the button
Seat 4: fmorandi (45892 in chips) 
Seat 5: Caio Mugarte (21608 in chips) 
fmorandi: posts the ante 75
Caio Mugarte: posts the ante 75
fmorandi: posts small blind 600
Caio Mugarte: posts big blind 1200
*** HOLE CARDS ***
Dealt to Caio Mugarte [7c 3s]
fmorandi: folds 
Uncalled bet (600) returned to Caio Mugarte
Caio Mugarte collected 1350 from pot
Caio Mugarte: doesn't show hand 
*** SUMMARY ***
Total pot 1350 | Rake 0 
Seat 4: fmorandi (button) (small blind) folded before Flop
Seat 5: Caio Mugarte (big blind) collected (1350)



PokerStars Hand #245448856738: Tournament #3632677041, $0.23+$0.02 USD Hold'em No Limit - Level XIII (600/1200) - 2023/08/17 19:41:15 AT [2023/08/17 18:41:15 ET]
Table '3632677041 4' 9-max Seat #5 is the button
Seat 4: fmorandi (45217 in chips) 
Seat 5: Caio Mugarte (22283 in chips) 
fmorandi: posts the ante 75
Caio Mugarte: posts the ante 75
Caio Mugarte: posts small blind 600
fmorandi: posts big blind 1200
*** HOLE CARDS ***
Dealt to Caio Mugarte [6s 9d]
Caio Mugarte: calls 600
fmorandi: raises 2400 to 3600
Caio Mugarte: folds 
Uncalled bet (2400) returned to fmorandi
fmorandi collected 2550 from pot
*** SUMMARY ***
Total pot 2550 | Rake 0 
Seat 4: fmorandi (big blind) collected (2550)
Seat 5: Caio Mugarte (button) (small blind) folded before Flop



PokerStars Hand #245448859541: Tournament #3632677041, $0.23+$0.02 USD Hold'em No Limit - Level XIII (600/1200) - 2023/08/17 19:41:25 AT [2023/08/17 18:41:25 ET]
Table '3632677041 4' 9-max Seat #4 is the button
Seat 4: fmorandi (46492 in chips) 
Seat 5: Caio Mugarte (21008 in chips) 
fmorandi: posts the ante 75
Caio Mugarte: posts the ante 75
fmorandi: posts small blind 600
Caio Mugarte: posts big blind 1200
*** HOLE CARDS ***
Dealt to Caio Mugarte [9h Qs]
fmorandi: raises 1200 to 2400
Caio Mugarte: calls 1200
*** FLOP *** [8c 3d 7c]
Caio Mugarte: checks 
fmorandi: bets 1200
Caio Mugarte: folds 
Uncalled bet (1200) returned to fmorandi
fmorandi collected 4950 from pot
*** SUMMARY ***
Total pot 4950 | Rake 0 
Board [8c 3d 7c]
Seat 4: fmorandi (button) (small blind) collected (4950)
Seat 5: Caio Mugarte (big blind) folded on the Flop



PokerStars Hand #245448864321: Tournament #3632677041, $0.23+$0.02 USD Hold'em No Limit - Level XIII (600/1200) - 2023/08/17 19:41:42 AT [2023/08/17 18:41:42 ET]
Table '3632677041 4' 9-max Seat #5 is the button
Seat 4: fmorandi (48967 in chips) 
Seat 5: Caio Mugarte (18533 in chips) 
fmorandi: posts the ante 75
Caio Mugarte: posts the ante 75
Caio Mugarte: posts small blind 600
fmorandi: posts big blind 1200
*** HOLE CARDS ***
Dealt to Caio Mugarte [4h 3c]
Caio Mugarte: calls 600
fmorandi: raises 1200 to 2400
Caio Mugarte: calls 1200
*** FLOP *** [9c 5d Qd]
fmorandi: checks 
Caio Mugarte: checks 
*** TURN *** [9c 5d Qd] [6h]
fmorandi: bets 2400
Caio Mugarte: calls 2400
*** RIVER *** [9c 5d Qd 6h] [4d]
fmorandi: bets 2400
Caio Mugarte: folds 
Uncalled bet (2400) returned to fmorandi
fmorandi collected 9750 from pot
*** SUMMARY ***
Total pot 9750 | Rake 0 
Board [9c 5d Qd 6h 4d]
Seat 4: fmorandi (big blind) collected (9750)
Seat 5: Caio Mugarte (button) (small blind) folded on the River



PokerStars Hand #245448874501: Tournament #3632677041, $0.23+$0.02 USD Hold'em No Limit - Level XIII (600/1200) - 2023/08/17 19:42:18 AT [2023/08/17 18:42:18 ET]
Table '3632677041 4' 9-max Seat #4 is the button
Seat 4: fmorandi (53842 in chips) 
Seat 5: Caio Mugarte (13658 in chips) 
fmorandi: posts the ante 75
Caio Mugarte: posts the ante 75
fmorandi: posts small blind 600
Caio Mugarte: posts big blind 1200
*** HOLE CARDS ***
Dealt to Caio Mugarte [8c 8s]
fmorandi: folds 
Uncalled bet (600) returned to Caio Mugarte
Caio Mugarte collected 1350 from pot
Caio Mugarte: doesn't show hand 
*** SUMMARY ***
Total pot 1350 | Rake 0 
Seat 4: fmorandi (button) (small blind) folded before Flop
Seat 5: Caio Mugarte (big blind) collected (1350)



PokerStars Hand #245448876250: Tournament #3632677041, $0.23+$0.02 USD Hold'em No Limit - Level XIII (600/1200) - 2023/08/17 19:42:24 AT [2023/08/17 18:42:24 ET]
Table '3632677041 4' 9-max Seat #5 is the button
Seat 4: fmorandi (53167 in chips) 
Seat 5: Caio Mugarte (14333 in chips) 
fmorandi: posts the ante 75
Caio Mugarte: posts the ante 75
Caio Mugarte: posts small blind 600
fmorandi: posts big blind 1200
*** HOLE CARDS ***
Dealt to Caio Mugarte [Qd Ah]
Caio Mugarte: calls 600
fmorandi: checks 
*** FLOP *** [8d 9d 2h]
fmorandi: bets 1200
Caio Mugarte: raises 11858 to 13058 and is all-in
fmorandi: folds 
Uncalled bet (11858) returned to Caio Mugarte
Caio Mugarte collected 4950 from pot
Caio Mugarte: doesn't show hand 
*** SUMMARY ***
Total pot 4950 | Rake 0 
Board [8d 9d 2h]
Seat 4: fmorandi (big blind) folded on the Flop
Seat 5: Caio Mugarte (button) (small blind) collected (4950)



PokerStars Hand #245448882188: Tournament #3632677041, $0.23+$0.02 USD Hold'em No Limit - Level XIII (600/1200) - 2023/08/17 19:42:45 AT [2023/08/17 18:42:45 ET]
Table '3632677041 4' 9-max Seat #4 is the button
Seat 4: fmorandi (50692 in chips) 
Seat 5: Caio Mugarte (16808 in chips) 
fmorandi: posts the ante 75
Caio Mugarte: posts the ante 75
fmorandi: posts small blind 600
Caio Mugarte: posts big blind 1200
*** HOLE CARDS ***
Dealt to Caio Mugarte [Jh 5s]
fmorandi: raises 1200 to 2400
Caio Mugarte: folds 
Uncalled bet (1200) returned to fmorandi
fmorandi collected 2550 from pot
*** SUMMARY ***
Total pot 2550 | Rake 0 
Seat 4: fmorandi (button) (small blind) collected (2550)
Seat 5: Caio Mugarte (big blind) folded before Flop



