PokerStars Hand #245424678529: Tournament #3632163743, $0.23+$0.02 USD Hold'em No Limit - Level I (10/20) - 2023/08/16 14:12:54 AT [2023/08/16 13:12:54 ET]
Table '3632163743 5' 9-max Seat #2 is the button
Seat 1: Ziggyti (1494 in chips) 
Seat 2: Kuanyin156 (3133 in chips) is sitting out
Seat 3: RenanLovers93 (1218 in chips) 
Seat 4: pLeomaxxxx (1732 in chips) 
Seat 5: EnSi55 (1491 in chips) 
Seat 6: paullovell1 (1500 in chips) 
Seat 7: Caio Mugarte (1500 in chips) 
Seat 8: stalin191137 (1497 in chips) 
Seat 9: deju501 (1500 in chips) 
Ziggyti: posts the ante 3
Kuanyin156: posts the ante 3
RenanLovers93: posts the ante 3
pLeomaxxxx: posts the ante 3
EnSi55: posts the ante 3
paullovell1: posts the ante 3
Caio Mugarte: posts the ante 3
stalin191137: posts the ante 3
deju501: posts the ante 3
RenanLovers93: posts small blind 10
pLeomaxxxx: posts big blind 20
*** HOLE CARDS ***
Dealt to Caio Mugarte [Qc 7d]
EnSi55: folds 
paullovell1: folds 
Caio Mugarte: folds 
stalin191137: folds 
deju501: folds 
Ziggyti: folds 
Kuanyin156: folds 
RenanLovers93: calls 10
Kuanyin156 has returned
pLeomaxxxx: checks 
*** FLOP *** [Ac 2c 6d]
RenanLovers93: checks 
pLeomaxxxx: bets 34
RenanLovers93: calls 34
*** TURN *** [Ac 2c 6d] [Tc]
RenanLovers93: checks 
pLeomaxxxx: bets 68
RenanLovers93: calls 68
*** RIVER *** [Ac 2c 6d Tc] [3s]
RenanLovers93: checks 
pLeomaxxxx: checks 
*** SHOW DOWN ***
RenanLovers93: shows [6c Qh] (a pair of Sixes)
pLeomaxxxx: mucks hand 
RenanLovers93 collected 271 from pot
*** SUMMARY ***
Total pot 271 | Rake 0 
Board [Ac 2c 6d Tc 3s]
Seat 1: Ziggyti folded before Flop (didn't bet)
Seat 2: Kuanyin156 (button) folded before Flop (didn't bet)
Seat 3: RenanLovers93 (small blind) showed [6c Qh] and won (271) with a pair of Sixes
Seat 4: pLeomaxxxx (big blind) mucked [6s 9c]
Seat 5: EnSi55 folded before Flop (didn't bet)
Seat 6: paullovell1 folded before Flop (didn't bet)
Seat 7: Caio Mugarte folded before Flop (didn't bet)
Seat 8: stalin191137 folded before Flop (didn't bet)
Seat 9: deju501 folded before Flop (didn't bet)



PokerStars Hand #245424689193: Tournament #3632163743, $0.23+$0.02 USD Hold'em No Limit - Level I (10/20) - 2023/08/16 14:13:33 AT [2023/08/16 13:13:33 ET]
Table '3632163743 5' 9-max Seat #3 is the button
Seat 1: Ziggyti (1491 in chips) 
Seat 2: Kuanyin156 (3130 in chips) 
Seat 3: RenanLovers93 (1364 in chips) 
Seat 4: pLeomaxxxx (1607 in chips) 
Seat 5: EnSi55 (1488 in chips) 
Seat 6: paullovell1 (1497 in chips) 
Seat 7: Caio Mugarte (1497 in chips) 
Seat 8: stalin191137 (1494 in chips) 
Seat 9: deju501 (1497 in chips) 
Ziggyti: posts the ante 3
Kuanyin156: posts the ante 3
RenanLovers93: posts the ante 3
pLeomaxxxx: posts the ante 3
EnSi55: posts the ante 3
paullovell1: posts the ante 3
Caio Mugarte: posts the ante 3
stalin191137: posts the ante 3
deju501: posts the ante 3
pLeomaxxxx: posts small blind 10
EnSi55: posts big blind 20
*** HOLE CARDS ***
Dealt to Caio Mugarte [Qd Td]
paullovell1: folds 
Caio Mugarte: raises 20 to 40
stalin191137: folds 
deju501: calls 40
Ziggyti: raises 160 to 200
Kuanyin156: folds 
RenanLovers93: folds 
pLeomaxxxx: folds 
EnSi55: folds 
Caio Mugarte: folds 
deju501: folds 
Uncalled bet (160) returned to Ziggyti
Ziggyti collected 177 from pot
*** SUMMARY ***
Total pot 177 | Rake 0 
Seat 1: Ziggyti collected (177)
Seat 2: Kuanyin156 folded before Flop (didn't bet)
Seat 3: RenanLovers93 (button) folded before Flop (didn't bet)
Seat 4: pLeomaxxxx (small blind) folded before Flop
Seat 5: EnSi55 (big blind) folded before Flop
Seat 6: paullovell1 folded before Flop (didn't bet)
Seat 7: Caio Mugarte folded before Flop
Seat 8: stalin191137 folded before Flop (didn't bet)
Seat 9: deju501 folded before Flop



PokerStars Hand #245424698338: Tournament #3632163743, $0.23+$0.02 USD Hold'em No Limit - Level I (10/20) - 2023/08/16 14:14:07 AT [2023/08/16 13:14:07 ET]
Table '3632163743 5' 9-max Seat #4 is the button
Seat 1: Ziggyti (1625 in chips) 
Seat 2: Kuanyin156 (3127 in chips) 
Seat 3: RenanLovers93 (1361 in chips) 
Seat 4: pLeomaxxxx (1594 in chips) 
Seat 5: EnSi55 (1465 in chips) 
Seat 6: paullovell1 (1494 in chips) 
Seat 7: Caio Mugarte (1454 in chips) 
Seat 8: stalin191137 (1491 in chips) 
Seat 9: deju501 (1454 in chips) 
Ziggyti: posts the ante 3
Kuanyin156: posts the ante 3
RenanLovers93: posts the ante 3
pLeomaxxxx: posts the ante 3
EnSi55: posts the ante 3
paullovell1: posts the ante 3
Caio Mugarte: posts the ante 3
stalin191137: posts the ante 3
deju501: posts the ante 3
EnSi55: posts small blind 10
paullovell1: posts big blind 20
*** HOLE CARDS ***
Dealt to Caio Mugarte [Qd 9d]
Caio Mugarte: folds 
stalin191137: folds 
deju501: folds 
Ziggyti: folds 
Kuanyin156: calls 20
RenanLovers93: raises 60 to 80
pLeomaxxxx: calls 80
EnSi55: folds 
paullovell1: calls 60
Kuanyin156: calls 60
*** FLOP *** [2c Jh 2s]
paullovell1: checks 
Kuanyin156: checks 
RenanLovers93: bets 179
pLeomaxxxx: folds 
paullovell1: folds 
Kuanyin156: calls 179
*** TURN *** [2c Jh 2s] [4s]
Kuanyin156: bets 140
RenanLovers93: calls 140
*** RIVER *** [2c Jh 2s 4s] [6s]
Kuanyin156: bets 120
RenanLovers93: calls 120
*** SHOW DOWN ***
Kuanyin156: shows [9h Js] (two pair, Jacks and Deuces)
RenanLovers93: shows [Ad Jd] (two pair, Jacks and Deuces - Ace kicker)
RenanLovers93 collected 1235 from pot
*** SUMMARY ***
Total pot 1235 | Rake 0 
Board [2c Jh 2s 4s 6s]
Seat 1: Ziggyti folded before Flop (didn't bet)
Seat 2: Kuanyin156 showed [9h Js] and lost with two pair, Jacks and Deuces
Seat 3: RenanLovers93 showed [Ad Jd] and won (1235) with two pair, Jacks and Deuces
Seat 4: pLeomaxxxx (button) folded on the Flop
Seat 5: EnSi55 (small blind) folded before Flop
Seat 6: paullovell1 (big blind) folded on the Flop
Seat 7: Caio Mugarte folded before Flop (didn't bet)
Seat 8: stalin191137 folded before Flop (didn't bet)
Seat 9: deju501 folded before Flop (didn't bet)



PokerStars Hand #245424712695: Tournament #3632163743, $0.23+$0.02 USD Hold'em No Limit - Level I (10/20) - 2023/08/16 14:15:00 AT [2023/08/16 13:15:00 ET]
Table '3632163743 5' 9-max Seat #5 is the button
Seat 1: Ziggyti (1622 in chips) 
Seat 2: Kuanyin156 (2605 in chips) 
Seat 3: RenanLovers93 (2074 in chips) 
Seat 4: pLeomaxxxx (1511 in chips) 
Seat 5: EnSi55 (1452 in chips) 
Seat 6: paullovell1 (1411 in chips) 
Seat 7: Caio Mugarte (1451 in chips) 
Seat 8: stalin191137 (1488 in chips) 
Seat 9: deju501 (1451 in chips) 
Ziggyti: posts the ante 3
Kuanyin156: posts the ante 3
RenanLovers93: posts the ante 3
pLeomaxxxx: posts the ante 3
EnSi55: posts the ante 3
paullovell1: posts the ante 3
Caio Mugarte: posts the ante 3
stalin191137: posts the ante 3
deju501: posts the ante 3
paullovell1: posts small blind 10
Caio Mugarte: posts big blind 20
*** HOLE CARDS ***
Dealt to Caio Mugarte [6d Jd]
stalin191137: folds 
deju501: folds 
Ziggyti: folds 
Kuanyin156: raises 20 to 40
RenanLovers93: calls 40
pLeomaxxxx: folds 
EnSi55: folds 
paullovell1: folds 
Caio Mugarte: calls 20
*** FLOP *** [4h 6s 7c]
Caio Mugarte: checks 
Kuanyin156: bets 79
RenanLovers93: calls 79
Caio Mugarte: calls 79
*** TURN *** [4h 6s 7c] [5d]
Caio Mugarte: checks 
Kuanyin156: checks 
RenanLovers93: checks 
*** RIVER *** [4h 6s 7c 5d] [8s]
Caio Mugarte: checks 
Kuanyin156: checks 
RenanLovers93: checks 
*** SHOW DOWN ***
Caio Mugarte: shows [6d Jd] (a straight, Four to Eight)
Kuanyin156: shows [7h Ah] (a straight, Four to Eight)
RenanLovers93: shows [Jh Ac] (a straight, Four to Eight)
Caio Mugarte collected 132 from pot
Kuanyin156 collected 131 from pot
RenanLovers93 collected 131 from pot
*** SUMMARY ***
Total pot 394 | Rake 0 
Board [4h 6s 7c 5d 8s]
Seat 1: Ziggyti folded before Flop (didn't bet)
Seat 2: Kuanyin156 showed [7h Ah] and won (131) with a straight, Four to Eight
Seat 3: RenanLovers93 showed [Jh Ac] and won (131) with a straight, Four to Eight
Seat 4: pLeomaxxxx folded before Flop (didn't bet)
Seat 5: EnSi55 (button) folded before Flop (didn't bet)
Seat 6: paullovell1 (small blind) folded before Flop
Seat 7: Caio Mugarte (big blind) showed [6d Jd] and won (132) with a straight, Four to Eight
Seat 8: stalin191137 folded before Flop (didn't bet)
Seat 9: deju501 folded before Flop (didn't bet)



PokerStars Hand #245424725893: Tournament #3632163743, $0.23+$0.02 USD Hold'em No Limit - Level I (10/20) - 2023/08/16 14:15:48 AT [2023/08/16 13:15:48 ET]
Table '3632163743 5' 9-max Seat #6 is the button
Seat 1: Ziggyti (1619 in chips) 
Seat 2: Kuanyin156 (2614 in chips) 
Seat 3: RenanLovers93 (2083 in chips) 
Seat 4: pLeomaxxxx (1508 in chips) 
Seat 5: EnSi55 (1449 in chips) 
Seat 6: paullovell1 (1398 in chips) 
Seat 7: Caio Mugarte (1461 in chips) 
Seat 8: stalin191137 (1485 in chips) 
Seat 9: deju501 (1448 in chips) 
Ziggyti: posts the ante 3
Kuanyin156: posts the ante 3
RenanLovers93: posts the ante 3
pLeomaxxxx: posts the ante 3
EnSi55: posts the ante 3
paullovell1: posts the ante 3
Caio Mugarte: posts the ante 3
stalin191137: posts the ante 3
deju501: posts the ante 3
Caio Mugarte: posts small blind 10
stalin191137: posts big blind 20
*** HOLE CARDS ***
Dealt to Caio Mugarte [Qs 2h]
deju501: calls 20
Ziggyti: folds 
Kuanyin156: calls 20
RenanLovers93: folds 
pLeomaxxxx has timed out
pLeomaxxxx: folds 
pLeomaxxxx is sitting out
EnSi55: folds 
paullovell1: folds 
Caio Mugarte: folds 
stalin191137: checks 
*** FLOP *** [Td 7c 9h]
pLeomaxxxx has returned
stalin191137: bets 97
deju501: folds 
Kuanyin156: calls 97
*** TURN *** [Td 7c 9h] [6s]
stalin191137: checks 
Kuanyin156: bets 146
stalin191137: folds 
Uncalled bet (146) returned to Kuanyin156
Kuanyin156 collected 291 from pot
Kuanyin156: doesn't show hand 
*** SUMMARY ***
Total pot 291 | Rake 0 
Board [Td 7c 9h 6s]
Seat 1: Ziggyti folded before Flop (didn't bet)
Seat 2: Kuanyin156 collected (291)
Seat 3: RenanLovers93 folded before Flop (didn't bet)
Seat 4: pLeomaxxxx folded before Flop (didn't bet)
Seat 5: EnSi55 folded before Flop (didn't bet)
Seat 6: paullovell1 (button) folded before Flop (didn't bet)
Seat 7: Caio Mugarte (small blind) folded before Flop
Seat 8: stalin191137 (big blind) folded on the Turn
Seat 9: deju501 folded on the Flop



PokerStars Hand #245424746681: Tournament #3632163743, $0.23+$0.02 USD Hold'em No Limit - Level I (10/20) - 2023/08/16 14:17:06 AT [2023/08/16 13:17:06 ET]
Table '3632163743 5' 9-max Seat #7 is the button
Seat 1: Ziggyti (1616 in chips) 
Seat 2: Kuanyin156 (2785 in chips) 
Seat 3: RenanLovers93 (2080 in chips) 
Seat 4: pLeomaxxxx (1505 in chips) 
Seat 5: EnSi55 (1446 in chips) 
Seat 6: paullovell1 (1395 in chips) 
Seat 7: Caio Mugarte (1448 in chips) 
Seat 8: stalin191137 (1365 in chips) 
Seat 9: deju501 (1425 in chips) 
Ziggyti: posts the ante 3
Kuanyin156: posts the ante 3
RenanLovers93: posts the ante 3
pLeomaxxxx: posts the ante 3
EnSi55: posts the ante 3
paullovell1: posts the ante 3
Caio Mugarte: posts the ante 3
stalin191137: posts the ante 3
deju501: posts the ante 3
stalin191137: posts small blind 10
deju501: posts big blind 20
*** HOLE CARDS ***
Dealt to Caio Mugarte [8h Qc]
Ziggyti: folds 
Kuanyin156: raises 40 to 60
RenanLovers93: folds 
pLeomaxxxx: calls 60
EnSi55: folds 
paullovell1: folds 
Caio Mugarte: folds 
stalin191137: folds 
deju501: folds 
*** FLOP *** [Ac Th 7h]
Kuanyin156: checks 
pLeomaxxxx: bets 89
Kuanyin156: calls 89
*** TURN *** [Ac Th 7h] [3d]
Kuanyin156: bets 178
pLeomaxxxx: folds 
Uncalled bet (178) returned to Kuanyin156
Kuanyin156 collected 355 from pot
Kuanyin156: doesn't show hand 
*** SUMMARY ***
Total pot 355 | Rake 0 
Board [Ac Th 7h 3d]
Seat 1: Ziggyti folded before Flop (didn't bet)
Seat 2: Kuanyin156 collected (355)
Seat 3: RenanLovers93 folded before Flop (didn't bet)
Seat 4: pLeomaxxxx folded on the Turn
Seat 5: EnSi55 folded before Flop (didn't bet)
Seat 6: paullovell1 folded before Flop (didn't bet)
Seat 7: Caio Mugarte (button) folded before Flop (didn't bet)
Seat 8: stalin191137 (small blind) folded before Flop
Seat 9: deju501 (big blind) folded before Flop



PokerStars Hand #245424760597: Tournament #3632163743, $0.23+$0.02 USD Hold'em No Limit - Level I (10/20) - 2023/08/16 14:17:58 AT [2023/08/16 13:17:58 ET]
Table '3632163743 5' 9-max Seat #8 is the button
Seat 1: Ziggyti (1613 in chips) 
Seat 2: Kuanyin156 (2988 in chips) 
Seat 3: RenanLovers93 (2077 in chips) 
Seat 4: pLeomaxxxx (1353 in chips) 
Seat 5: EnSi55 (1443 in chips) 
Seat 6: paullovell1 (1392 in chips) 
Seat 7: Caio Mugarte (1445 in chips) 
Seat 8: stalin191137 (1352 in chips) 
Seat 9: deju501 (1402 in chips) 
Ziggyti: posts the ante 3
Kuanyin156: posts the ante 3
RenanLovers93: posts the ante 3
pLeomaxxxx: posts the ante 3
EnSi55: posts the ante 3
paullovell1: posts the ante 3
Caio Mugarte: posts the ante 3
stalin191137: posts the ante 3
deju501: posts the ante 3
deju501: posts small blind 10
Ziggyti: posts big blind 20
*** HOLE CARDS ***
Dealt to Caio Mugarte [5c 8d]
Kuanyin156: raises 20 to 40
RenanLovers93: folds 
pLeomaxxxx: folds 
EnSi55: folds 
paullovell1: calls 40
Caio Mugarte: folds 
stalin191137: folds 
deju501: folds 
Ziggyti: calls 20
*** FLOP *** [Tc Ad Jd]
Ziggyti: checks 
Kuanyin156: checks 
paullovell1: bets 79
Ziggyti: folds 
Kuanyin156: calls 79
*** TURN *** [Tc Ad Jd] [2h]
Kuanyin156: checks 
paullovell1: bets 158
Kuanyin156: calls 158
*** RIVER *** [Tc Ad Jd 2h] [Qc]
Kuanyin156: checks 
paullovell1: checks 
*** SHOW DOWN ***
Kuanyin156: shows [Kd Qs] (a straight, Ten to Ace)
paullovell1: mucks hand 
Kuanyin156 collected 631 from pot
*** SUMMARY ***
Total pot 631 | Rake 0 
Board [Tc Ad Jd 2h Qc]
Seat 1: Ziggyti (big blind) folded on the Flop
Seat 2: Kuanyin156 showed [Kd Qs] and won (631) with a straight, Ten to Ace
Seat 3: RenanLovers93 folded before Flop (didn't bet)
Seat 4: pLeomaxxxx folded before Flop (didn't bet)
Seat 5: EnSi55 folded before Flop (didn't bet)
Seat 6: paullovell1 mucked [9s Js]
Seat 7: Caio Mugarte folded before Flop (didn't bet)
Seat 8: stalin191137 (button) folded before Flop (didn't bet)
Seat 9: deju501 (small blind) folded before Flop



PokerStars Hand #245424774285: Tournament #3632163743, $0.23+$0.02 USD Hold'em No Limit - Level I (10/20) - 2023/08/16 14:18:48 AT [2023/08/16 13:18:48 ET]
Table '3632163743 5' 9-max Seat #9 is the button
Seat 1: Ziggyti (1570 in chips) 
Seat 2: Kuanyin156 (3339 in chips) 
Seat 3: RenanLovers93 (2074 in chips) 
Seat 4: pLeomaxxxx (1350 in chips) 
Seat 5: EnSi55 (1440 in chips) 
Seat 6: paullovell1 (1112 in chips) 
Seat 7: Caio Mugarte (1442 in chips) 
Seat 8: stalin191137 (1349 in chips) 
Seat 9: deju501 (1389 in chips) 
Ziggyti: posts the ante 3
Kuanyin156: posts the ante 3
RenanLovers93: posts the ante 3
pLeomaxxxx: posts the ante 3
EnSi55: posts the ante 3
paullovell1: posts the ante 3
Caio Mugarte: posts the ante 3
stalin191137: posts the ante 3
deju501: posts the ante 3
Ziggyti: posts small blind 10
Kuanyin156: posts big blind 20
*** HOLE CARDS ***
Dealt to Caio Mugarte [Qc 4s]
RenanLovers93: folds 
pLeomaxxxx: raises 40 to 60
EnSi55: folds 
paullovell1: folds 
Caio Mugarte: folds 
stalin191137: folds 
deju501: calls 60
Ziggyti: folds 
Kuanyin156: calls 40
*** FLOP *** [5s 2h Js]
Kuanyin156: checks 
pLeomaxxxx: bets 20
deju501: folds 
Kuanyin156: calls 20
*** TURN *** [5s 2h Js] [6h]
Kuanyin156: checks 
pLeomaxxxx: bets 40
Kuanyin156: calls 40
*** RIVER *** [5s 2h Js 6h] [6c]
Kuanyin156: checks 
pLeomaxxxx: checks 
*** SHOW DOWN ***
Kuanyin156: shows [Qs 3h] (a pair of Sixes)
pLeomaxxxx: shows [Ks As] (a pair of Sixes - Ace kicker)
pLeomaxxxx collected 337 from pot
*** SUMMARY ***
Total pot 337 | Rake 0 
Board [5s 2h Js 6h 6c]
Seat 1: Ziggyti (small blind) folded before Flop
Seat 2: Kuanyin156 (big blind) showed [Qs 3h] and lost with a pair of Sixes
Seat 3: RenanLovers93 folded before Flop (didn't bet)
Seat 4: pLeomaxxxx showed [Ks As] and won (337) with a pair of Sixes
Seat 5: EnSi55 folded before Flop (didn't bet)
Seat 6: paullovell1 folded before Flop (didn't bet)
Seat 7: Caio Mugarte folded before Flop (didn't bet)
Seat 8: stalin191137 folded before Flop (didn't bet)
Seat 9: deju501 (button) folded on the Flop



PokerStars Hand #245424787175: Tournament #3632163743, $0.23+$0.02 USD Hold'em No Limit - Level II (15/30) - 2023/08/16 14:19:36 AT [2023/08/16 13:19:36 ET]
Table '3632163743 5' 9-max Seat #1 is the button
Seat 1: Ziggyti (1557 in chips) 
Seat 2: Kuanyin156 (3216 in chips) 
Seat 3: RenanLovers93 (2071 in chips) 
Seat 4: pLeomaxxxx (1564 in chips) 
Seat 5: EnSi55 (1437 in chips) 
Seat 6: paullovell1 (1109 in chips) 
Seat 7: Caio Mugarte (1439 in chips) 
Seat 8: stalin191137 (1346 in chips) 
Seat 9: deju501 (1326 in chips) 
Ziggyti: posts the ante 4
Kuanyin156: posts the ante 4
RenanLovers93: posts the ante 4
pLeomaxxxx: posts the ante 4
EnSi55: posts the ante 4
paullovell1: posts the ante 4
Caio Mugarte: posts the ante 4
stalin191137: posts the ante 4
deju501: posts the ante 4
Kuanyin156: posts small blind 15
RenanLovers93: posts big blind 30
*** HOLE CARDS ***
Dealt to Caio Mugarte [2c Tc]
pLeomaxxxx: folds 
EnSi55: calls 30
paullovell1: folds 
Caio Mugarte: folds 
stalin191137: folds 
deju501: folds 
Ziggyti: folds 
Kuanyin156: calls 15
RenanLovers93: checks 
*** FLOP *** [2d 7h 3h]
Kuanyin156: checks 
RenanLovers93: bets 126
EnSi55: calls 126
Kuanyin156: folds 
*** TURN *** [2d 7h 3h] [2h]
RenanLovers93: bets 378
EnSi55: folds 
Uncalled bet (378) returned to RenanLovers93
RenanLovers93 collected 378 from pot
*** SUMMARY ***
Total pot 378 | Rake 0 
Board [2d 7h 3h 2h]
Seat 1: Ziggyti (button) folded before Flop (didn't bet)
Seat 2: Kuanyin156 (small blind) folded on the Flop
Seat 3: RenanLovers93 (big blind) collected (378)
Seat 4: pLeomaxxxx folded before Flop (didn't bet)
Seat 5: EnSi55 folded on the Turn
Seat 6: paullovell1 folded before Flop (didn't bet)
Seat 7: Caio Mugarte folded before Flop (didn't bet)
Seat 8: stalin191137 folded before Flop (didn't bet)
Seat 9: deju501 folded before Flop (didn't bet)



PokerStars Hand #245424799389: Tournament #3632163743, $0.23+$0.02 USD Hold'em No Limit - Level II (15/30) - 2023/08/16 14:20:20 AT [2023/08/16 13:20:20 ET]
Table '3632163743 5' 9-max Seat #2 is the button
Seat 1: Ziggyti (1553 in chips) 
Seat 2: Kuanyin156 (3182 in chips) 
Seat 3: RenanLovers93 (2289 in chips) 
Seat 4: pLeomaxxxx (1560 in chips) 
Seat 5: EnSi55 (1277 in chips) 
Seat 6: paullovell1 (1105 in chips) 
Seat 7: Caio Mugarte (1435 in chips) 
Seat 9: deju501 (1322 in chips) 
Ziggyti: posts the ante 4
Kuanyin156: posts the ante 4
RenanLovers93: posts the ante 4
pLeomaxxxx: posts the ante 4
EnSi55: posts the ante 4
paullovell1: posts the ante 4
Caio Mugarte: posts the ante 4
deju501: posts the ante 4
RenanLovers93: posts small blind 15
pLeomaxxxx: posts big blind 30
*** HOLE CARDS ***
Dealt to Caio Mugarte [7s 2d]
EnSi55: folds 
paullovell1: folds 
Caio Mugarte: folds 
deju501: folds 
Ziggyti: folds 
Kuanyin156: calls 30
RenanLovers93: calls 15
pLeomaxxxx: checks 
*** FLOP *** [3c 7d Qh]
RenanLovers93: bets 122
pLeomaxxxx: calls 122
Kuanyin156: folds 
*** TURN *** [3c 7d Qh] [Jc]
RenanLovers93: bets 366
pLeomaxxxx: folds 
Uncalled bet (366) returned to RenanLovers93
RenanLovers93 collected 366 from pot
*** SUMMARY ***
Total pot 366 | Rake 0 
Board [3c 7d Qh Jc]
Seat 1: Ziggyti folded before Flop (didn't bet)
Seat 2: Kuanyin156 (button) folded on the Flop
Seat 3: RenanLovers93 (small blind) collected (366)
Seat 4: pLeomaxxxx (big blind) folded on the Turn
Seat 5: EnSi55 folded before Flop (didn't bet)
Seat 6: paullovell1 folded before Flop (didn't bet)
Seat 7: Caio Mugarte folded before Flop (didn't bet)
Seat 9: deju501 folded before Flop (didn't bet)



PokerStars Hand #245424810797: Tournament #3632163743, $0.23+$0.02 USD Hold'em No Limit - Level II (15/30) - 2023/08/16 14:21:02 AT [2023/08/16 13:21:02 ET]
Table '3632163743 5' 9-max Seat #3 is the button
Seat 1: Ziggyti (1549 in chips) 
Seat 2: Kuanyin156 (3148 in chips) 
Seat 3: RenanLovers93 (2499 in chips) 
Seat 4: pLeomaxxxx (1404 in chips) 
Seat 5: EnSi55 (1273 in chips) 
Seat 6: paullovell1 (1101 in chips) 
Seat 7: Caio Mugarte (1431 in chips) 
Seat 9: deju501 (1318 in chips) 
Ziggyti: posts the ante 4
Kuanyin156: posts the ante 4
RenanLovers93: posts the ante 4
pLeomaxxxx: posts the ante 4
EnSi55: posts the ante 4
paullovell1: posts the ante 4
Caio Mugarte: posts the ante 4
deju501: posts the ante 4
pLeomaxxxx: posts small blind 15
EnSi55: posts big blind 30
*** HOLE CARDS ***
Dealt to Caio Mugarte [Ts 3d]
paullovell1: folds 
Caio Mugarte: folds 
deju501: folds 
Ziggyti: folds 
Kuanyin156: calls 30
RenanLovers93: calls 30
pLeomaxxxx: raises 60 to 90
EnSi55: calls 60
Kuanyin156: calls 60
RenanLovers93: calls 60
*** FLOP *** [3s Td 4d]
pLeomaxxxx: checks 
EnSi55: checks 
Kuanyin156: checks 
RenanLovers93: checks 
*** TURN *** [3s Td 4d] [Ac]
pLeomaxxxx: checks 
EnSi55: checks 
Kuanyin156: checks 
RenanLovers93: checks 
*** RIVER *** [3s Td 4d Ac] [Qs]
pLeomaxxxx: bets 30
EnSi55: calls 30
Kuanyin156: folds 
RenanLovers93: calls 30
*** SHOW DOWN ***
pLeomaxxxx: shows [6h 5h] (high card Ace)
EnSi55: shows [Jd As] (a pair of Aces)
RenanLovers93: shows [Qd Js] (a pair of Queens)
EnSi55 collected 482 from pot
*** SUMMARY ***
Total pot 482 | Rake 0 
Board [3s Td 4d Ac Qs]
Seat 1: Ziggyti folded before Flop (didn't bet)
Seat 2: Kuanyin156 folded on the River
Seat 3: RenanLovers93 (button) showed [Qd Js] and lost with a pair of Queens
Seat 4: pLeomaxxxx (small blind) showed [6h 5h] and lost with high card Ace
Seat 5: EnSi55 (big blind) showed [Jd As] and won (482) with a pair of Aces
Seat 6: paullovell1 folded before Flop (didn't bet)
Seat 7: Caio Mugarte folded before Flop (didn't bet)
Seat 9: deju501 folded before Flop (didn't bet)



PokerStars Hand #245424825553: Tournament #3632163743, $0.23+$0.02 USD Hold'em No Limit - Level II (15/30) - 2023/08/16 14:21:55 AT [2023/08/16 13:21:55 ET]
Table '3632163743 5' 9-max Seat #4 is the button
Seat 1: Ziggyti (1545 in chips) 
Seat 2: Kuanyin156 (3054 in chips) 
Seat 3: RenanLovers93 (2375 in chips) 
Seat 4: pLeomaxxxx (1280 in chips) 
Seat 5: EnSi55 (1631 in chips) 
Seat 6: paullovell1 (1097 in chips) 
Seat 7: Caio Mugarte (1427 in chips) 
Seat 9: deju501 (1314 in chips) 
Ziggyti: posts the ante 4
Kuanyin156: posts the ante 4
RenanLovers93: posts the ante 4
pLeomaxxxx: posts the ante 4
EnSi55: posts the ante 4
paullovell1: posts the ante 4
Caio Mugarte: posts the ante 4
deju501: posts the ante 4
EnSi55: posts small blind 15
paullovell1: posts big blind 30
*** HOLE CARDS ***
Dealt to Caio Mugarte [Kd 9h]
Caio Mugarte: folds 
deju501: folds 
Ziggyti: folds 
Kuanyin156: raises 30 to 60
RenanLovers93: folds 
pLeomaxxxx: folds 
EnSi55: raises 30 to 90
paullovell1: folds 
Kuanyin156: calls 30
*** FLOP *** [Qs Jh 4s]
EnSi55: checks 
Kuanyin156: checks 
*** TURN *** [Qs Jh 4s] [4c]
EnSi55: bets 30
Kuanyin156: calls 30
*** RIVER *** [Qs Jh 4s 4c] [Ad]
EnSi55: bets 30
Kuanyin156: calls 30
*** SHOW DOWN ***
EnSi55: shows [Qh Qd] (a full house, Queens full of Fours)
Kuanyin156: mucks hand 
EnSi55 collected 362 from pot
*** SUMMARY ***
Total pot 362 | Rake 0 
Board [Qs Jh 4s 4c Ad]
Seat 1: Ziggyti folded before Flop (didn't bet)
Seat 2: Kuanyin156 mucked [8c As]
Seat 3: RenanLovers93 folded before Flop (didn't bet)
Seat 4: pLeomaxxxx (button) folded before Flop (didn't bet)
Seat 5: EnSi55 (small blind) showed [Qh Qd] and won (362) with a full house, Queens full of Fours
Seat 6: paullovell1 (big blind) folded before Flop
Seat 7: Caio Mugarte folded before Flop (didn't bet)
Seat 9: deju501 folded before Flop (didn't bet)



PokerStars Hand #245424837685: Tournament #3632163743, $0.23+$0.02 USD Hold'em No Limit - Level II (15/30) - 2023/08/16 14:22:38 AT [2023/08/16 13:22:38 ET]
Table '3632163743 5' 9-max Seat #5 is the button
Seat 1: Ziggyti (1541 in chips) 
Seat 2: Kuanyin156 (2900 in chips) 
Seat 3: RenanLovers93 (2371 in chips) 
Seat 4: pLeomaxxxx (1276 in chips) 
Seat 5: EnSi55 (1839 in chips) 
Seat 6: paullovell1 (1063 in chips) 
Seat 7: Caio Mugarte (1423 in chips) 
Seat 9: deju501 (1310 in chips) 
Ziggyti: posts the ante 4
Kuanyin156: posts the ante 4
RenanLovers93: posts the ante 4
pLeomaxxxx: posts the ante 4
EnSi55: posts the ante 4
paullovell1: posts the ante 4
Caio Mugarte: posts the ante 4
deju501: posts the ante 4
paullovell1: posts small blind 15
Caio Mugarte: posts big blind 30
*** HOLE CARDS ***
Dealt to Caio Mugarte [2d Jc]
deju501: folds 
Ziggyti: raises 30 to 60
Kuanyin156: calls 60
RenanLovers93: raises 30 to 90
pLeomaxxxx: folds 
EnSi55: calls 90
paullovell1: folds 
Caio Mugarte: folds 
Ziggyti: calls 30
Kuanyin156: calls 30
*** FLOP *** [8c 9c 4d]
Ziggyti: checks 
Kuanyin156: checks 
RenanLovers93: checks 
EnSi55: checks 
*** TURN *** [8c 9c 4d] [9h]
Ziggyti: bets 300
Kuanyin156: folds 
RenanLovers93: folds 
EnSi55: folds 
Uncalled bet (300) returned to Ziggyti
Rosa885 is disconnected 
Ziggyti collected 437 from pot
*** SUMMARY ***
Total pot 437 | Rake 0 
Board [8c 9c 4d 9h]
Seat 1: Ziggyti collected (437)
Seat 2: Kuanyin156 folded on the Turn
Seat 3: RenanLovers93 folded on the Turn
Seat 4: pLeomaxxxx folded before Flop (didn't bet)
Seat 5: EnSi55 (button) folded on the Turn
Seat 6: paullovell1 (small blind) folded before Flop
Seat 7: Caio Mugarte (big blind) folded before Flop
Seat 9: deju501 folded before Flop (didn't bet)



PokerStars Hand #245424852999: Tournament #3632163743, $0.23+$0.02 USD Hold'em No Limit - Level II (15/30) - 2023/08/16 14:23:33 AT [2023/08/16 13:23:33 ET]
Table '3632163743 5' 9-max Seat #6 is the button
Seat 1: Ziggyti (1884 in chips) 
Seat 2: Kuanyin156 (2806 in chips) 
Seat 3: RenanLovers93 (2277 in chips) 
Seat 4: pLeomaxxxx (1272 in chips) 
Seat 5: EnSi55 (1745 in chips) 
Seat 6: paullovell1 (1044 in chips) 
Seat 7: Caio Mugarte (1389 in chips) 
Seat 8: Rosa885 (1197 in chips) 
Seat 9: deju501 (1306 in chips) 
Ziggyti: posts the ante 4
Kuanyin156: posts the ante 4
RenanLovers93: posts the ante 4
pLeomaxxxx: posts the ante 4
EnSi55: posts the ante 4
paullovell1: posts the ante 4
Caio Mugarte: posts the ante 4
Rosa885: posts the ante 4
deju501: posts the ante 4
Caio Mugarte: posts small blind 15
Rosa885: posts big blind 30
*** HOLE CARDS ***
Dealt to Caio Mugarte [4d Js]
deju501: folds 
Ziggyti: raises 30 to 60
Kuanyin156: calls 60
RenanLovers93: raises 261 to 321
pLeomaxxxx: calls 321
EnSi55: folds 
paullovell1: folds 
Caio Mugarte: folds 
Rosa885: calls 291
Ziggyti: folds 
Kuanyin156: folds 
*** FLOP *** [Qd 2c 3d]
Rosa885: bets 578
RenanLovers93: raises 578 to 1156
pLeomaxxxx: calls 947 and is all-in
Rosa885: calls 294 and is all-in
Uncalled bet (209) returned to RenanLovers93
*** TURN *** [Qd 2c 3d] [Td]
*** RIVER *** [Qd 2c 3d Td] [Th]
*** SHOW DOWN ***
RenanLovers93: shows [Jd Jc] (two pair, Jacks and Tens)
pLeomaxxxx: shows [Qs Kd] (two pair, Queens and Tens)
pLeomaxxxx collected 150 from side pot
Rosa885: shows [Qh Ah] (two pair, Queens and Tens - Ace kicker)
Rosa885 collected 3750 from main pot
*** SUMMARY ***
Total pot 3900 Main pot 3750. Side pot 150. | Rake 0 
Board [Qd 2c 3d Td Th]
Seat 1: Ziggyti folded before Flop
Seat 2: Kuanyin156 folded before Flop
Seat 3: RenanLovers93 showed [Jd Jc] and lost with two pair, Jacks and Tens
Seat 4: pLeomaxxxx showed [Qs Kd] and won (150) with two pair, Queens and Tens
Seat 5: EnSi55 folded before Flop (didn't bet)
Seat 6: paullovell1 (button) folded before Flop (didn't bet)
Seat 7: Caio Mugarte (small blind) folded before Flop
Seat 8: Rosa885 (big blind) showed [Qh Ah] and won (3750) with two pair, Queens and Tens
Seat 9: deju501 folded before Flop (didn't bet)



PokerStars Hand #245424873035: Tournament #3632163743, $0.23+$0.02 USD Hold'em No Limit - Level II (15/30) - 2023/08/16 14:24:46 AT [2023/08/16 13:24:46 ET]
Table '3632163743 5' 9-max Seat #7 is the button
Seat 1: Ziggyti (1820 in chips) 
Seat 2: Kuanyin156 (2742 in chips) 
Seat 3: RenanLovers93 (1005 in chips) 
Seat 4: pLeomaxxxx (150 in chips) 
Seat 5: EnSi55 (1741 in chips) 
Seat 6: paullovell1 (1040 in chips) 
Seat 7: Caio Mugarte (1370 in chips) 
Seat 8: Rosa885 (3750 in chips) 
Seat 9: deju501 (1302 in chips) 
Ziggyti: posts the ante 4
Kuanyin156: posts the ante 4
RenanLovers93: posts the ante 4
pLeomaxxxx: posts the ante 4
EnSi55: posts the ante 4
paullovell1: posts the ante 4
Caio Mugarte: posts the ante 4
Rosa885: posts the ante 4
deju501: posts the ante 4
Rosa885: posts small blind 15
deju501: posts big blind 30
*** HOLE CARDS ***
Dealt to Caio Mugarte [7h 6h]
Ziggyti: folds 
Kuanyin156: raises 30 to 60
RenanLovers93: folds 
pLeomaxxxx: raises 86 to 146 and is all-in
EnSi55: calls 146
paullovell1: folds 
Caio Mugarte: folds 
Rosa885: folds 
deju501: folds 
Kuanyin156: calls 86
*** FLOP *** [Ad Jh Kc]
Kuanyin156: checks 
EnSi55: checks 
*** TURN *** [Ad Jh Kc] [4c]
Kuanyin156: bets 240
EnSi55: folds 
Uncalled bet (240) returned to Kuanyin156
*** RIVER *** [Ad Jh Kc 4c] [Tc]
*** SHOW DOWN ***
Kuanyin156: shows [Ah Jd] (two pair, Aces and Jacks)
pLeomaxxxx: shows [Kd 4h] (two pair, Kings and Fours)
Kuanyin156 collected 519 from pot
pLeomaxxxx finished the tournament in 36th place
*** SUMMARY ***
Total pot 519 | Rake 0 
Board [Ad Jh Kc 4c Tc]
Seat 1: Ziggyti folded before Flop (didn't bet)
Seat 2: Kuanyin156 showed [Ah Jd] and won (519) with two pair, Aces and Jacks
Seat 3: RenanLovers93 folded before Flop (didn't bet)
Seat 4: pLeomaxxxx showed [Kd 4h] and lost with two pair, Kings and Fours
Seat 5: EnSi55 folded on the Turn
Seat 6: paullovell1 folded before Flop (didn't bet)
Seat 7: Caio Mugarte (button) folded before Flop (didn't bet)
Seat 8: Rosa885 (small blind) folded before Flop
Seat 9: deju501 (big blind) folded before Flop



PokerStars Hand #245424884199: Tournament #3632163743, $0.23+$0.02 USD Hold'em No Limit - Level II (15/30) - 2023/08/16 14:25:27 AT [2023/08/16 13:25:27 ET]
Table '3632163743 5' 9-max Seat #8 is the button
Seat 1: Ziggyti (1816 in chips) 
Seat 2: Kuanyin156 (3111 in chips) 
Seat 3: RenanLovers93 (1001 in chips) 
Seat 5: EnSi55 (1591 in chips) 
Seat 6: paullovell1 (1036 in chips) 
Seat 7: Caio Mugarte (1366 in chips) 
Seat 8: Rosa885 (3731 in chips) 
Seat 9: deju501 (1268 in chips) 
Ziggyti: posts the ante 4
Kuanyin156: posts the ante 4
RenanLovers93: posts the ante 4
EnSi55: posts the ante 4
paullovell1: posts the ante 4
Caio Mugarte: posts the ante 4
Rosa885: posts the ante 4
deju501: posts the ante 4
deju501: posts small blind 15
Ziggyti: posts big blind 30
*** HOLE CARDS ***
Dealt to Caio Mugarte [5s 3c]
Kuanyin156: raises 30 to 60
RenanLovers93: folds 
EnSi55: folds 
paullovell1: folds 
Caio Mugarte: folds 
Rosa885: folds 
deju501: folds 
Ziggyti: calls 30
*** FLOP *** [Ac 4c 4d]
Ziggyti: checks 
Kuanyin156: checks 
*** TURN *** [Ac 4c 4d] [6c]
Ziggyti: checks 
Kuanyin156: bets 90
Ziggyti: calls 90
*** RIVER *** [Ac 4c 4d 6c] [Qh]
Ziggyti: checks 
Kuanyin156: bets 150
Ziggyti: calls 150
*** SHOW DOWN ***
Kuanyin156: shows [Kc 9c] (a flush, Ace high)
Ziggyti: mucks hand 
Kuanyin156 collected 647 from pot
*** SUMMARY ***
Total pot 647 | Rake 0 
Board [Ac 4c 4d 6c Qh]
Seat 1: Ziggyti (big blind) mucked [Ks As]
Seat 2: Kuanyin156 showed [Kc 9c] and won (647) with a flush, Ace high
Seat 3: RenanLovers93 folded before Flop (didn't bet)
Seat 5: EnSi55 folded before Flop (didn't bet)
Seat 6: paullovell1 folded before Flop (didn't bet)
Seat 7: Caio Mugarte folded before Flop (didn't bet)
Seat 8: Rosa885 (button) folded before Flop (didn't bet)
Seat 9: deju501 (small blind) folded before Flop



PokerStars Hand #245424897775: Tournament #3632163743, $0.23+$0.02 USD Hold'em No Limit - Level II (15/30) - 2023/08/16 14:26:15 AT [2023/08/16 13:26:15 ET]
Table '3632163743 5' 9-max Seat #9 is the button
Seat 1: Ziggyti (1512 in chips) 
Seat 2: Kuanyin156 (3454 in chips) 
Seat 3: RenanLovers93 (997 in chips) 
Seat 5: EnSi55 (1587 in chips) 
Seat 6: paullovell1 (1032 in chips) 
Seat 7: Caio Mugarte (1362 in chips) 
Seat 8: Rosa885 (3727 in chips) 
Seat 9: deju501 (1249 in chips) 
Ziggyti: posts the ante 4
Kuanyin156: posts the ante 4
RenanLovers93: posts the ante 4
EnSi55: posts the ante 4
paullovell1: posts the ante 4
Caio Mugarte: posts the ante 4
Rosa885: posts the ante 4
deju501: posts the ante 4
Ziggyti: posts small blind 15
Kuanyin156: posts big blind 30
*** HOLE CARDS ***
Dealt to Caio Mugarte [Kc Ks]
RenanLovers93: raises 963 to 993 and is all-in
EnSi55: folds 
paullovell1: folds 
Caio Mugarte: raises 365 to 1358 and is all-in
Rosa885: folds 
deju501: folds 
Ziggyti: folds 
Kuanyin156: folds 
Uncalled bet (365) returned to Caio Mugarte
*** FLOP *** [2h 8c 9d]
*** TURN *** [2h 8c 9d] [Ad]
*** RIVER *** [2h 8c 9d Ad] [Jd]
*** SHOW DOWN ***
RenanLovers93: shows [6h 6c] (a pair of Sixes)
Caio Mugarte: shows [Kc Ks] (a pair of Kings)
Caio Mugarte collected 2063 from pot
RenanLovers93 finished the tournament in 35th place
*** SUMMARY ***
Total pot 2063 | Rake 0 
Board [2h 8c 9d Ad Jd]
Seat 1: Ziggyti (small blind) folded before Flop
Seat 2: Kuanyin156 (big blind) folded before Flop
Seat 3: RenanLovers93 showed [6h 6c] and lost with a pair of Sixes
Seat 5: EnSi55 folded before Flop (didn't bet)
Seat 6: paullovell1 folded before Flop (didn't bet)
Seat 7: Caio Mugarte showed [Kc Ks] and won (2063) with a pair of Kings
Seat 8: Rosa885 folded before Flop (didn't bet)
Seat 9: deju501 (button) folded before Flop (didn't bet)



PokerStars Hand #245424903993: Tournament #3632163743, $0.23+$0.02 USD Hold'em No Limit - Level II (15/30) - 2023/08/16 14:26:38 AT [2023/08/16 13:26:38 ET]
Table '3632163743 5' 9-max Seat #1 is the button
Seat 1: Ziggyti (1493 in chips) 
Seat 2: Kuanyin156 (3420 in chips) 
Seat 5: EnSi55 (1583 in chips) 
Seat 6: paullovell1 (1028 in chips) 
Seat 7: Caio Mugarte (2428 in chips) 
Seat 8: Rosa885 (3723 in chips) 
Seat 9: deju501 (1245 in chips) 
Ziggyti: posts the ante 4
Kuanyin156: posts the ante 4
EnSi55: posts the ante 4
paullovell1: posts the ante 4
Caio Mugarte: posts the ante 4
Rosa885: posts the ante 4
deju501: posts the ante 4
Kuanyin156: posts small blind 15
EnSi55: posts big blind 30
*** HOLE CARDS ***
Dealt to Caio Mugarte [3d 9h]
paullovell1: folds 
Caio Mugarte: folds 
Rosa885: folds 
deju501: calls 30
Ziggyti: folds 
Kuanyin156: raises 30 to 60
EnSi55: calls 30
deju501: calls 30
*** FLOP *** [3s Ts 3c]
Tallir is disconnected 
Kuanyin156: checks 
EnSi55: checks 
deju501: checks 
*** TURN *** [3s Ts 3c] [8c]
Kuanyin156: bets 104
EnSi55: folds 
deju501: calls 104
*** RIVER *** [3s Ts 3c 8c] [Qs]
Kuanyin156: bets 120
deju501: folds 
Uncalled bet (120) returned to Kuanyin156
Kuanyin156 collected 416 from pot
Kuanyin156: doesn't show hand 
*** SUMMARY ***
Total pot 416 | Rake 0 
Board [3s Ts 3c 8c Qs]
Seat 1: Ziggyti (button) folded before Flop (didn't bet)
Seat 2: Kuanyin156 (small blind) collected (416)
Seat 5: EnSi55 (big blind) folded on the Turn
Seat 6: paullovell1 folded before Flop (didn't bet)
Seat 7: Caio Mugarte folded before Flop (didn't bet)
Seat 8: Rosa885 folded before Flop (didn't bet)
Seat 9: deju501 folded on the River



PokerStars Hand #245424918458: Tournament #3632163743, $0.23+$0.02 USD Hold'em No Limit - Level II (15/30) - 2023/08/16 14:27:31 AT [2023/08/16 13:27:31 ET]
Table '3632163743 5' 9-max Seat #2 is the button
Seat 1: Ziggyti (1489 in chips) 
Seat 2: Kuanyin156 (3668 in chips) 
Seat 3: Tallir (2746 in chips) out of hand (moved from another table into small blind)
Seat 5: EnSi55 (1519 in chips) 
Seat 6: paullovell1 (1024 in chips) 
Seat 7: Caio Mugarte (2424 in chips) 
Seat 8: Rosa885 (3719 in chips) 
Seat 9: deju501 (1077 in chips) 
Tallir will be allowed to play after the button
Ziggyti: posts the ante 4
Kuanyin156: posts the ante 4
EnSi55: posts the ante 4
paullovell1: posts the ante 4
Caio Mugarte: posts the ante 4
Rosa885: posts the ante 4
deju501: posts the ante 4
EnSi55: posts small blind 15
paullovell1: posts big blind 30
*** HOLE CARDS ***
Dealt to Caio Mugarte [3h 8d]
Caio Mugarte: folds 
Rosa885: folds 
deju501: folds 
Ziggyti: folds 
Kuanyin156: raises 30 to 60
EnSi55: folds 
paullovell1: folds 
Uncalled bet (30) returned to Kuanyin156
Kuanyin156 collected 103 from pot
Kuanyin156: doesn't show hand 
*** SUMMARY ***
Total pot 103 | Rake 0 
Seat 1: Ziggyti folded before Flop (didn't bet)
Seat 2: Kuanyin156 (button) collected (103)
Seat 5: EnSi55 (small blind) folded before Flop
Seat 6: paullovell1 (big blind) folded before Flop
Seat 7: Caio Mugarte folded before Flop (didn't bet)
Seat 8: Rosa885 folded before Flop (didn't bet)
Seat 9: deju501 folded before Flop (didn't bet)



PokerStars Hand #245424923271: Tournament #3632163743, $0.23+$0.02 USD Hold'em No Limit - Level II (15/30) - 2023/08/16 14:27:48 AT [2023/08/16 13:27:48 ET]
Table '3632163743 5' 9-max Seat #5 is the button
Seat 1: Ziggyti (1485 in chips) 
Seat 2: Kuanyin156 (3737 in chips) 
Seat 3: Tallir (2746 in chips) 
Seat 5: EnSi55 (1500 in chips) 
Seat 6: paullovell1 (990 in chips) 
Seat 7: Caio Mugarte (2420 in chips) 
Seat 8: Rosa885 (3715 in chips) 
Seat 9: deju501 (1073 in chips) 
Ziggyti: posts the ante 4
Kuanyin156: posts the ante 4
Tallir: posts the ante 4
EnSi55: posts the ante 4
paullovell1: posts the ante 4
Caio Mugarte: posts the ante 4
Rosa885: posts the ante 4
deju501: posts the ante 4
paullovell1: posts small blind 15
Caio Mugarte: posts big blind 30
*** HOLE CARDS ***
Dealt to Caio Mugarte [9h 8h]
Rosa885: folds 
deju501: folds 
Ziggyti: folds 
Kuanyin156: raises 30 to 60
Tallir: folds 
EnSi55: folds 
paullovell1: folds 
Caio Mugarte: calls 30
*** FLOP *** [Ah 2h Ad]
Caio Mugarte: checks 
Kuanyin156: bets 30
Caio Mugarte: calls 30
*** TURN *** [Ah 2h Ad] [8c]
Caio Mugarte: checks 
Kuanyin156: checks 
*** RIVER *** [Ah 2h Ad 8c] [6h]
Caio Mugarte: bets 90
Kuanyin156: calls 90
*** SHOW DOWN ***
Caio Mugarte: shows [9h 8h] (a flush, Ace high)
Kuanyin156: mucks hand 
Caio Mugarte collected 407 from pot
*** SUMMARY ***
Total pot 407 | Rake 0 
Board [Ah 2h Ad 8c 6h]
Seat 1: Ziggyti folded before Flop (didn't bet)
Seat 2: Kuanyin156 mucked [Kd 2d]
Seat 3: Tallir folded before Flop (didn't bet)
Seat 5: EnSi55 (button) folded before Flop (didn't bet)
Seat 6: paullovell1 (small blind) folded before Flop
Seat 7: Caio Mugarte (big blind) showed [9h 8h] and won (407) with a flush, Ace high
Seat 8: Rosa885 folded before Flop (didn't bet)
Seat 9: deju501 folded before Flop (didn't bet)



PokerStars Hand #245424940905: Tournament #3632163743, $0.23+$0.02 USD Hold'em No Limit - Level II (15/30) - 2023/08/16 14:28:52 AT [2023/08/16 13:28:52 ET]
Table '3632163743 5' 9-max Seat #6 is the button
Seat 1: Ziggyti (1481 in chips) 
Seat 2: Kuanyin156 (3553 in chips) 
Seat 3: Tallir (2742 in chips) 
Seat 5: EnSi55 (1496 in chips) 
Seat 6: paullovell1 (971 in chips) 
Seat 7: Caio Mugarte (2643 in chips) 
Seat 8: Rosa885 (3711 in chips) 
Seat 9: deju501 (1069 in chips) 
Ziggyti: posts the ante 4
Kuanyin156: posts the ante 4
Tallir: posts the ante 4
EnSi55: posts the ante 4
paullovell1: posts the ante 4
Caio Mugarte: posts the ante 4
Rosa885: posts the ante 4
deju501: posts the ante 4
Caio Mugarte: posts small blind 15
Rosa885: posts big blind 30
*** HOLE CARDS ***
Dealt to Caio Mugarte [7c 3d]
deju501: folds 
Ziggyti: folds 
Kuanyin156: folds 
Tallir: folds 
EnSi55: calls 30
paullovell1: raises 937 to 967 and is all-in
Caio Mugarte: folds 
Rosa885: folds 
EnSi55: calls 937
*** FLOP *** [8h Ks 2s]
*** TURN *** [8h Ks 2s] [Tc]
*** RIVER *** [8h Ks 2s Tc] [6h]
*** SHOW DOWN ***
EnSi55: shows [6c Ah] (a pair of Sixes)
paullovell1: shows [Js Jc] (a pair of Jacks)
paullovell1 collected 2011 from pot
*** SUMMARY ***
Total pot 2011 | Rake 0 
Board [8h Ks 2s Tc 6h]
Seat 1: Ziggyti folded before Flop (didn't bet)
Seat 2: Kuanyin156 folded before Flop (didn't bet)
Seat 3: Tallir folded before Flop (didn't bet)
Seat 5: EnSi55 showed [6c Ah] and lost with a pair of Sixes
Seat 6: paullovell1 (button) showed [Js Jc] and won (2011) with a pair of Jacks
Seat 7: Caio Mugarte (small blind) folded before Flop
Seat 8: Rosa885 (big blind) folded before Flop
Seat 9: deju501 folded before Flop (didn't bet)



PokerStars Hand #245424952271: Tournament #3632163743, $0.23+$0.02 USD Hold'em No Limit - Level III (25/50) - 2023/08/16 14:29:33 AT [2023/08/16 13:29:33 ET]
Table '3632163743 5' 9-max Seat #7 is the button
Seat 1: Ziggyti (1477 in chips) 
Seat 2: Kuanyin156 (3549 in chips) 
Seat 3: Tallir (2738 in chips) 
Seat 5: EnSi55 (525 in chips) 
Seat 6: paullovell1 (2011 in chips) 
Seat 7: Caio Mugarte (2624 in chips) 
Seat 8: Rosa885 (3677 in chips) 
Seat 9: deju501 (1065 in chips) 
Ziggyti: posts the ante 6
Kuanyin156: posts the ante 6
Tallir: posts the ante 6
EnSi55: posts the ante 6
paullovell1: posts the ante 6
Caio Mugarte: posts the ante 6
Rosa885: posts the ante 6
deju501: posts the ante 6
Rosa885: posts small blind 25
deju501: posts big blind 50
*** HOLE CARDS ***
Dealt to Caio Mugarte [Qc Ks]
Ziggyti: folds 
Kuanyin156: folds 
Tallir: calls 50
EnSi55: folds 
paullovell1: calls 50
Caio Mugarte: folds 
Rosa885: folds 
deju501: checks 
*** FLOP *** [7s 4s 9h]
deju501: checks 
Tallir: checks 
paullovell1: checks 
*** TURN *** [7s 4s 9h] [Jc]
deju501: checks 
Tallir: bets 50
paullovell1: calls 50
deju501: folds 
*** RIVER *** [7s 4s 9h Jc] [2s]
Tallir: checks 
paullovell1: bets 162
Tallir: calls 162
*** SHOW DOWN ***
paullovell1: shows [Qh Tc] (high card Queen)
Tallir: shows [Js Kd] (a pair of Jacks)
Tallir collected 647 from pot
*** SUMMARY ***
Total pot 647 | Rake 0 
Board [7s 4s 9h Jc 2s]
Seat 1: Ziggyti folded before Flop (didn't bet)
Seat 2: Kuanyin156 folded before Flop (didn't bet)
Seat 3: Tallir showed [Js Kd] and won (647) with a pair of Jacks
Seat 5: EnSi55 folded before Flop (didn't bet)
Seat 6: paullovell1 showed [Qh Tc] and lost with high card Queen
Seat 7: Caio Mugarte (button) folded before Flop (didn't bet)
Seat 8: Rosa885 (small blind) folded before Flop
Seat 9: deju501 (big blind) folded on the Turn



PokerStars Hand #245424966120: Tournament #3632163743, $0.23+$0.02 USD Hold'em No Limit - Level III (25/50) - 2023/08/16 14:30:22 AT [2023/08/16 13:30:22 ET]
Table '3632163743 5' 9-max Seat #8 is the button
Seat 1: Ziggyti (1471 in chips) 
Seat 2: Kuanyin156 (3543 in chips) 
Seat 3: Tallir (3117 in chips) 
Seat 5: EnSi55 (519 in chips) 
Seat 6: paullovell1 (1743 in chips) 
Seat 7: Caio Mugarte (2618 in chips) 
Seat 8: Rosa885 (3646 in chips) 
Seat 9: deju501 (1009 in chips) 
Ziggyti: posts the ante 6
Kuanyin156: posts the ante 6
Tallir: posts the ante 6
EnSi55: posts the ante 6
paullovell1: posts the ante 6
Caio Mugarte: posts the ante 6
Rosa885: posts the ante 6
deju501: posts the ante 6
deju501: posts small blind 25
Ziggyti: posts big blind 50
*** HOLE CARDS ***
Dealt to Caio Mugarte [4c Jh]
Kuanyin156: folds 
Tallir: calls 50
EnSi55: raises 463 to 513 and is all-in
paullovell1: raises 1224 to 1737 and is all-in
Caio Mugarte: folds 
Rosa885: folds 
deju501: folds 
Ziggyti: folds 
Tallir: folds 
Uncalled bet (1224) returned to paullovell1
*** FLOP *** [7d Td 3h]
*** TURN *** [7d Td 3h] [5c]
*** RIVER *** [7d Td 3h 5c] [9h]
*** SHOW DOWN ***
EnSi55: shows [9s Ac] (a pair of Nines)
paullovell1: shows [8c 8h] (a pair of Eights)
EnSi55 collected 1199 from pot
*** SUMMARY ***
Total pot 1199 | Rake 0 
Board [7d Td 3h 5c 9h]
Seat 1: Ziggyti (big blind) folded before Flop
Seat 2: Kuanyin156 folded before Flop (didn't bet)
Seat 3: Tallir folded before Flop
Seat 5: EnSi55 showed [9s Ac] and won (1199) with a pair of Nines
Seat 6: paullovell1 showed [8c 8h] and lost with a pair of Eights
Seat 7: Caio Mugarte folded before Flop (didn't bet)
Seat 8: Rosa885 (button) folded before Flop (didn't bet)
Seat 9: deju501 (small blind) folded before Flop



PokerStars Hand #245424976425: Tournament #3632163743, $0.23+$0.02 USD Hold'em No Limit - Level III (25/50) - 2023/08/16 14:30:59 AT [2023/08/16 13:30:59 ET]
Table '3632163743 5' 9-max Seat #9 is the button
Seat 1: Ziggyti (1415 in chips) 
Seat 2: Kuanyin156 (3537 in chips) 
Seat 3: Tallir (3061 in chips) 
Seat 5: EnSi55 (1199 in chips) 
Seat 6: paullovell1 (1224 in chips) 
Seat 7: Caio Mugarte (2612 in chips) 
Seat 8: Rosa885 (3640 in chips) 
Seat 9: deju501 (978 in chips) 
Ziggyti: posts the ante 6
Kuanyin156: posts the ante 6
Tallir: posts the ante 6
EnSi55: posts the ante 6
paullovell1: posts the ante 6
Caio Mugarte: posts the ante 6
Rosa885: posts the ante 6
deju501: posts the ante 6
Ziggyti: posts small blind 25
Kuanyin156: posts big blind 50
*** HOLE CARDS ***
Dealt to Caio Mugarte [3h 3s]
Tallir: folds 
EnSi55: folds 
paullovell1: folds 
Caio Mugarte: raises 50 to 100
Rosa885: calls 100
deju501: folds 
Ziggyti: folds 
Kuanyin156: calls 50
*** FLOP *** [As 6s 5s]
Kuanyin156: checks 
Caio Mugarte: checks 
Rosa885: checks 
*** TURN *** [As 6s 5s] [7d]
Kuanyin156: checks 
Caio Mugarte: checks 
Rosa885: checks 
*** RIVER *** [As 6s 5s 7d] [Qh]
Kuanyin156: checks 
Caio Mugarte: bets 100
Rosa885: calls 100
Kuanyin156: folds 
*** SHOW DOWN ***
Caio Mugarte: shows [3h 3s] (a pair of Threes)
Rosa885: shows [Jd Jh] (a pair of Jacks)
Rosa885 collected 573 from pot
*** SUMMARY ***
Total pot 573 | Rake 0 
Board [As 6s 5s 7d Qh]
Seat 1: Ziggyti (small blind) folded before Flop
Seat 2: Kuanyin156 (big blind) folded on the River
Seat 3: Tallir folded before Flop (didn't bet)
Seat 5: EnSi55 folded before Flop (didn't bet)
Seat 6: paullovell1 folded before Flop (didn't bet)
Seat 7: Caio Mugarte showed [3h 3s] and lost with a pair of Threes
Seat 8: Rosa885 showed [Jd Jh] and won (573) with a pair of Jacks
Seat 9: deju501 (button) folded before Flop (didn't bet)



PokerStars Hand #245424996946: Tournament #3632163743, $0.23+$0.02 USD Hold'em No Limit - Level III (25/50) - 2023/08/16 14:32:12 AT [2023/08/16 13:32:12 ET]
Table '3632163743 5' 9-max Seat #1 is the button
Seat 1: Ziggyti (1384 in chips) 
Seat 2: Kuanyin156 (3431 in chips) 
Seat 3: Tallir (3055 in chips) 
Seat 5: EnSi55 (1193 in chips) 
Seat 6: paullovell1 (1218 in chips) 
Seat 7: Caio Mugarte (2406 in chips) 
Seat 8: Rosa885 (4007 in chips) 
Seat 9: deju501 (972 in chips) 
Ziggyti: posts the ante 6
Kuanyin156: posts the ante 6
Tallir: posts the ante 6
EnSi55: posts the ante 6
paullovell1: posts the ante 6
Caio Mugarte: posts the ante 6
Rosa885: posts the ante 6
deju501: posts the ante 6
Kuanyin156: posts small blind 25
Tallir: posts big blind 50
*** HOLE CARDS ***
Dealt to Caio Mugarte [6s 2h]
EnSi55: folds 
paullovell1: folds 
Caio Mugarte: folds 
Rosa885: folds 
deju501: folds 
Ziggyti: folds 
Kuanyin156: calls 25
Tallir: checks 
*** FLOP *** [5d Js 7h]
Kuanyin156: bets 50
Tallir: calls 50
*** TURN *** [5d Js 7h] [Qd]
Kuanyin156: checks 
Tallir: checks 
*** RIVER *** [5d Js 7h Qd] [7d]
Kuanyin156: checks 
Tallir: checks 
*** SHOW DOWN ***
Kuanyin156: shows [6d 3c] (a pair of Sevens)
Tallir: shows [Ks 4s] (a pair of Sevens - King kicker)
Tallir collected 248 from pot
*** SUMMARY ***
Total pot 248 | Rake 0 
Board [5d Js 7h Qd 7d]
Seat 1: Ziggyti (button) folded before Flop (didn't bet)
Seat 2: Kuanyin156 (small blind) showed [6d 3c] and lost with a pair of Sevens
Seat 3: Tallir (big blind) showed [Ks 4s] and won (248) with a pair of Sevens
Seat 5: EnSi55 folded before Flop (didn't bet)
Seat 6: paullovell1 folded before Flop (didn't bet)
Seat 7: Caio Mugarte folded before Flop (didn't bet)
Seat 8: Rosa885 folded before Flop (didn't bet)
Seat 9: deju501 folded before Flop (didn't bet)



PokerStars Hand #245425006250: Tournament #3632163743, $0.23+$0.02 USD Hold'em No Limit - Level III (25/50) - 2023/08/16 14:32:45 AT [2023/08/16 13:32:45 ET]
Table '3632163743 5' 9-max Seat #2 is the button
Seat 1: Ziggyti (1378 in chips) 
Seat 2: Kuanyin156 (3325 in chips) 
Seat 3: Tallir (3197 in chips) 
Seat 5: EnSi55 (1187 in chips) 
Seat 6: paullovell1 (1212 in chips) 
Seat 7: Caio Mugarte (2400 in chips) 
Seat 8: Rosa885 (4001 in chips) 
Seat 9: deju501 (966 in chips) 
Ziggyti: posts the ante 6
Kuanyin156: posts the ante 6
Tallir: posts the ante 6
EnSi55: posts the ante 6
paullovell1: posts the ante 6
Caio Mugarte: posts the ante 6
Rosa885: posts the ante 6
deju501: posts the ante 6
Tallir: posts small blind 25
EnSi55: posts big blind 50
*** HOLE CARDS ***
Dealt to Caio Mugarte [5d 4c]
paullovell1: raises 1156 to 1206 and is all-in
Caio Mugarte: folds 
Rosa885 has timed out
Rosa885: folds 
Rosa885 is sitting out
deju501: folds 
Ziggyti: folds 
Kuanyin156: folds 
Tallir: folds 
EnSi55: folds 
Uncalled bet (1156) returned to paullovell1
paullovell1 collected 173 from pot
*** SUMMARY ***
Total pot 173 | Rake 0 
Seat 1: Ziggyti folded before Flop (didn't bet)
Seat 2: Kuanyin156 (button) folded before Flop (didn't bet)
Seat 3: Tallir (small blind) folded before Flop
Seat 5: EnSi55 (big blind) folded before Flop
Seat 6: paullovell1 collected (173)
Seat 7: Caio Mugarte folded before Flop (didn't bet)
Seat 8: Rosa885 folded before Flop (didn't bet)
Seat 9: deju501 folded before Flop (didn't bet)



PokerStars Hand #245425019918: Tournament #3632163743, $0.23+$0.02 USD Hold'em No Limit - Level III (25/50) - 2023/08/16 14:33:34 AT [2023/08/16 13:33:34 ET]
Table '3632163743 5' 9-max Seat #3 is the button
Seat 1: Ziggyti (1372 in chips) 
Seat 2: Kuanyin156 (3319 in chips) 
Seat 3: Tallir (3166 in chips) 
Seat 5: EnSi55 (1131 in chips) 
Seat 6: paullovell1 (1329 in chips) 
Seat 7: Caio Mugarte (2394 in chips) 
Seat 8: Rosa885 (3995 in chips) is sitting out
Seat 9: deju501 (960 in chips) 
Ziggyti: posts the ante 6
Kuanyin156: posts the ante 6
Tallir: posts the ante 6
EnSi55: posts the ante 6
paullovell1: posts the ante 6
Caio Mugarte: posts the ante 6
Rosa885: posts the ante 6
deju501: posts the ante 6
EnSi55: posts small blind 25
paullovell1: posts big blind 50
*** HOLE CARDS ***
Dealt to Caio Mugarte [4h 3d]
Caio Mugarte: folds 
Rosa885: folds 
deju501: folds 
Ziggyti: raises 50 to 100
Rosa885 has returned
Kuanyin156: calls 100
Tallir: folds 
EnSi55: folds 
paullovell1: calls 50
*** FLOP *** [6d Qh Kh]
paullovell1: checks 
Ziggyti: bets 150
Kuanyin156: folds 
paullovell1: folds 
Uncalled bet (150) returned to Ziggyti
Ziggyti collected 373 from pot
*** SUMMARY ***
Total pot 373 | Rake 0 
Board [6d Qh Kh]
Seat 1: Ziggyti collected (373)
Seat 2: Kuanyin156 folded on the Flop
Seat 3: Tallir (button) folded before Flop (didn't bet)
Seat 5: EnSi55 (small blind) folded before Flop
Seat 6: paullovell1 (big blind) folded on the Flop
Seat 7: Caio Mugarte folded before Flop (didn't bet)
Seat 8: Rosa885 folded before Flop (didn't bet)
Seat 9: deju501 folded before Flop (didn't bet)



PokerStars Hand #245425028499: Tournament #3632163743, $0.23+$0.02 USD Hold'em No Limit - Level III (25/50) - 2023/08/16 14:34:05 AT [2023/08/16 13:34:05 ET]
Table '3632163743 5' 9-max Seat #5 is the button
Seat 1: Ziggyti (1639 in chips) 
Seat 2: Kuanyin156 (3213 in chips) 
Seat 3: Tallir (3160 in chips) 
Seat 5: EnSi55 (1100 in chips) 
Seat 6: paullovell1 (1223 in chips) 
Seat 7: Caio Mugarte (2388 in chips) 
Seat 8: Rosa885 (3989 in chips) 
Seat 9: deju501 (954 in chips) 
Ziggyti: posts the ante 6
Kuanyin156: posts the ante 6
Tallir: posts the ante 6
EnSi55: posts the ante 6
paullovell1: posts the ante 6
Caio Mugarte: posts the ante 6
Rosa885: posts the ante 6
deju501: posts the ante 6
paullovell1: posts small blind 25
Caio Mugarte: posts big blind 50
*** HOLE CARDS ***
Dealt to Caio Mugarte [7d 7h]
Rosa885: folds 
deju501: calls 50
Ziggyti: folds 
Kuanyin156: calls 50
Tallir: calls 50
EnSi55: folds 
paullovell1: calls 25
Caio Mugarte: checks 
*** FLOP *** [Ad Ts 9h]
paullovell1: checks 
Caio Mugarte: checks 
deju501: bets 50
Kuanyin156: calls 50
Tallir: calls 50
paullovell1: folds 
Caio Mugarte: folds 
*** TURN *** [Ad Ts 9h] [Jd]
deju501: checks 
Kuanyin156: checks 
Tallir: checks 
*** RIVER *** [Ad Ts 9h Jd] [Qs]
deju501: checks 
Kuanyin156: checks 
Tallir: checks 
*** SHOW DOWN ***
deju501: shows [As 2d] (a pair of Aces)
Kuanyin156: shows [4s 8s] (a straight, Eight to Queen)
Tallir: mucks hand 
Kuanyin156 collected 448 from pot
*** SUMMARY ***
Total pot 448 | Rake 0 
Board [Ad Ts 9h Jd Qs]
Seat 1: Ziggyti folded before Flop (didn't bet)
Seat 2: Kuanyin156 showed [4s 8s] and won (448) with a straight, Eight to Queen
Seat 3: Tallir mucked [2c 2s]
Seat 5: EnSi55 (button) folded before Flop (didn't bet)
Seat 6: paullovell1 (small blind) folded on the Flop
Seat 7: Caio Mugarte (big blind) folded on the Flop
Seat 8: Rosa885 folded before Flop (didn't bet)
Seat 9: deju501 showed [As 2d] and lost with a pair of Aces



PokerStars Hand #245425045273: Tournament #3632163743, $0.23+$0.02 USD Hold'em No Limit - Level III (25/50) - 2023/08/16 14:35:05 AT [2023/08/16 13:35:05 ET]
Table '3632163743 5' 9-max Seat #6 is the button
Seat 1: Ziggyti (1633 in chips) 
Seat 2: Kuanyin156 (3555 in chips) 
Seat 3: Tallir (3054 in chips) 
Seat 5: EnSi55 (1094 in chips) 
Seat 6: paullovell1 (1167 in chips) 
Seat 7: Caio Mugarte (2332 in chips) 
Seat 8: Rosa885 (3983 in chips) 
Seat 9: deju501 (848 in chips) 
Ziggyti: posts the ante 6
Kuanyin156: posts the ante 6
Tallir: posts the ante 6
EnSi55: posts the ante 6
paullovell1: posts the ante 6
Caio Mugarte: posts the ante 6
Rosa885: posts the ante 6
deju501: posts the ante 6
Caio Mugarte: posts small blind 25
Rosa885: posts big blind 50
*** HOLE CARDS ***
Dealt to Caio Mugarte [Td Ac]
deju501: folds 
Ziggyti: folds 
Kuanyin156: calls 50
Tallir: calls 50
EnSi55: folds 
paullovell1: folds 
Caio Mugarte: folds 
Rosa885: checks 
*** FLOP *** [6s 7d 3s]
Rosa885: checks 
Kuanyin156: checks 
Tallir: checks 
*** TURN *** [6s 7d 3s] [Js]
Rosa885: checks 
Kuanyin156: checks 
Tallir: checks 
*** RIVER *** [6s 7d 3s Js] [2h]
Rosa885: checks 
Kuanyin156: checks 
Tallir: checks 
*** SHOW DOWN ***
Rosa885: shows [8d Qc] (high card Queen)
Kuanyin156: shows [9h Kc] (high card King)
Tallir: shows [4h Ah] (high card Ace)
Tallir collected 223 from pot
*** SUMMARY ***
Total pot 223 | Rake 0 
Board [6s 7d 3s Js 2h]
Seat 1: Ziggyti folded before Flop (didn't bet)
Seat 2: Kuanyin156 showed [9h Kc] and lost with high card King
Seat 3: Tallir showed [4h Ah] and won (223) with high card Ace
Seat 5: EnSi55 folded before Flop (didn't bet)
Seat 6: paullovell1 (button) folded before Flop (didn't bet)
Seat 7: Caio Mugarte (small blind) folded before Flop
Seat 8: Rosa885 (big blind) showed [8d Qc] and lost with high card Queen
Seat 9: deju501 folded before Flop (didn't bet)



PokerStars Hand #245425065798: Tournament #3632163743, $0.23+$0.02 USD Hold'em No Limit - Level III (25/50) - 2023/08/16 14:36:17 AT [2023/08/16 13:36:17 ET]
Table '3632163743 5' 9-max Seat #7 is the button
Seat 1: Ziggyti (1627 in chips) 
Seat 2: Kuanyin156 (3499 in chips) 
Seat 3: Tallir (3221 in chips) 
Seat 5: EnSi55 (1088 in chips) 
Seat 6: paullovell1 (1161 in chips) 
Seat 7: Caio Mugarte (2301 in chips) 
Seat 8: Rosa885 (3927 in chips) 
Seat 9: deju501 (842 in chips) 
Ziggyti: posts the ante 6
Kuanyin156: posts the ante 6
Tallir: posts the ante 6
EnSi55: posts the ante 6
paullovell1: posts the ante 6
Caio Mugarte: posts the ante 6
Rosa885: posts the ante 6
deju501: posts the ante 6
Rosa885: posts small blind 25
deju501: posts big blind 50
*** HOLE CARDS ***
Dealt to Caio Mugarte [4s 4d]
Ziggyti: folds 
Kuanyin156: calls 50
Tallir: folds 
EnSi55: folds 
paullovell1: raises 100 to 150
Caio Mugarte: calls 150
Rosa885: folds 
deju501: folds 
Kuanyin156: calls 100
*** FLOP *** [9d 5h 6s]
Kuanyin156: checks 
paullovell1: checks 
Caio Mugarte: checks 
*** TURN *** [9d 5h 6s] [Ad]
Kuanyin156: checks 
paullovell1: checks 
Caio Mugarte: bets 125
Kuanyin156: calls 125
paullovell1: folds 
*** RIVER *** [9d 5h 6s Ad] [2c]
Kuanyin156: bets 150
Caio Mugarte: folds 
Uncalled bet (150) returned to Kuanyin156
Kuanyin156 collected 823 from pot
Kuanyin156: doesn't show hand 
*** SUMMARY ***
Total pot 823 | Rake 0 
Board [9d 5h 6s Ad 2c]
Seat 1: Ziggyti folded before Flop (didn't bet)
Seat 2: Kuanyin156 collected (823)
Seat 3: Tallir folded before Flop (didn't bet)
Seat 5: EnSi55 folded before Flop (didn't bet)
Seat 6: paullovell1 folded on the Turn
Seat 7: Caio Mugarte (button) folded on the River
Seat 8: Rosa885 (small blind) folded before Flop
Seat 9: deju501 (big blind) folded before Flop



PokerStars Hand #245425085357: Tournament #3632163743, $0.23+$0.02 USD Hold'em No Limit - Level III (25/50) - 2023/08/16 14:37:27 AT [2023/08/16 13:37:27 ET]
Table '3632163743 5' 9-max Seat #8 is the button
Seat 1: Ziggyti (1621 in chips) 
Seat 2: Kuanyin156 (4041 in chips) 
Seat 3: Tallir (3215 in chips) 
Seat 5: EnSi55 (1082 in chips) 
Seat 6: paullovell1 (1005 in chips) 
Seat 7: Caio Mugarte (2020 in chips) 
Seat 8: Rosa885 (3896 in chips) 
Seat 9: deju501 (786 in chips) 
Ziggyti: posts the ante 6
Kuanyin156: posts the ante 6
Tallir: posts the ante 6
EnSi55: posts the ante 6
paullovell1: posts the ante 6
Caio Mugarte: posts the ante 6
Rosa885: posts the ante 6
deju501: posts the ante 6
deju501: posts small blind 25
Ziggyti: posts big blind 50
*** HOLE CARDS ***
Dealt to Caio Mugarte [As 5s]
Kuanyin156: calls 50
Tallir: calls 50
EnSi55: folds 
paullovell1: folds 
Caio Mugarte: raises 200 to 250
Rosa885: folds 
deju501: folds 
Ziggyti: calls 200
Kuanyin156: folds 
Tallir: folds 
*** FLOP *** [Ks 3d 5c]
Ziggyti: checks 
Caio Mugarte: bets 200
Ziggyti: calls 200
*** TURN *** [Ks 3d 5c] [9s]
Ziggyti: checks 
Caio Mugarte: bets 450
Ziggyti: folds 
Uncalled bet (450) returned to Caio Mugarte
Caio Mugarte collected 1073 from pot
Caio Mugarte: doesn't show hand 
*** SUMMARY ***
Total pot 1073 | Rake 0 
Board [Ks 3d 5c 9s]
Seat 1: Ziggyti (big blind) folded on the Turn
Seat 2: Kuanyin156 folded before Flop
Seat 3: Tallir folded before Flop
Seat 5: EnSi55 folded before Flop (didn't bet)
Seat 6: paullovell1 folded before Flop (didn't bet)
Seat 7: Caio Mugarte collected (1073)
Seat 8: Rosa885 (button) folded before Flop (didn't bet)
Seat 9: deju501 (small blind) folded before Flop



PokerStars Hand #245425103190: Tournament #3632163743, $0.23+$0.02 USD Hold'em No Limit - Level III (25/50) - 2023/08/16 14:38:30 AT [2023/08/16 13:38:30 ET]
Table '3632163743 5' 9-max Seat #9 is the button
Seat 1: Ziggyti (1165 in chips) 
Seat 2: Kuanyin156 (3985 in chips) 
Seat 3: Tallir (3159 in chips) 
Seat 5: EnSi55 (1076 in chips) 
Seat 6: paullovell1 (999 in chips) 
Seat 7: Caio Mugarte (2637 in chips) 
Seat 8: Rosa885 (3890 in chips) 
Seat 9: deju501 (755 in chips) 
Ziggyti: posts the ante 6
Kuanyin156: posts the ante 6
Tallir: posts the ante 6
EnSi55: posts the ante 6
paullovell1: posts the ante 6
Caio Mugarte: posts the ante 6
Rosa885: posts the ante 6
deju501: posts the ante 6
Ziggyti: posts small blind 25
Kuanyin156: posts big blind 50
*** HOLE CARDS ***
Dealt to Caio Mugarte [Ac Ad]
Tallir: calls 50
EnSi55: calls 50
paullovell1: folds 
Caio Mugarte: raises 175 to 225
Rosa885 has timed out
Rosa885: folds 
Rosa885 is sitting out
deju501: folds 
Ziggyti: folds 
Kuanyin156: folds 
Tallir: folds 
EnSi55: calls 175
*** FLOP *** [9c 7h 3c]
Rosa885 has returned
EnSi55: bets 312
Caio Mugarte: raises 2094 to 2406 and is all-in
EnSi55: calls 533 and is all-in
Uncalled bet (1561) returned to Caio Mugarte
*** TURN *** [9c 7h 3c] [3s]
*** RIVER *** [9c 7h 3c 3s] [9s]
*** SHOW DOWN ***
EnSi55: shows [Qh 9h] (a full house, Nines full of Threes)
Caio Mugarte: shows [Ac Ad] (two pair, Aces and Nines)
EnSi55 collected 2313 from pot
*** SUMMARY ***
Total pot 2313 | Rake 0 
Board [9c 7h 3c 3s 9s]
Seat 1: Ziggyti (small blind) folded before Flop
Seat 2: Kuanyin156 (big blind) folded before Flop
Seat 3: Tallir folded before Flop
Seat 5: EnSi55 showed [Qh 9h] and won (2313) with a full house, Nines full of Threes
Seat 6: paullovell1 folded before Flop (didn't bet)
Seat 7: Caio Mugarte showed [Ac Ad] and lost with two pair, Aces and Nines
Seat 8: Rosa885 folded before Flop (didn't bet)
Seat 9: deju501 (button) folded before Flop (didn't bet)



PokerStars Hand #245425120186: Tournament #3632163743, $0.23+$0.02 USD Hold'em No Limit - Level IV (40/80) - 2023/08/16 14:39:30 AT [2023/08/16 13:39:30 ET]
Table '3632163743 5' 9-max Seat #1 is the button
Seat 1: Ziggyti (1134 in chips) 
Seat 2: Kuanyin156 (3929 in chips) 
Seat 3: Tallir (3103 in chips) 
Seat 5: EnSi55 (2313 in chips) 
Seat 7: Caio Mugarte (1561 in chips) 
Seat 8: Rosa885 (3884 in chips) 
Seat 9: deju501 (749 in chips) 
Ziggyti: posts the ante 10
Kuanyin156: posts the ante 10
Tallir: posts the ante 10
EnSi55: posts the ante 10
Caio Mugarte: posts the ante 10
Rosa885: posts the ante 10
deju501: posts the ante 10
Kuanyin156: posts small blind 40
Tallir: posts big blind 80
*** HOLE CARDS ***
Dealt to Caio Mugarte [7h 8c]
EnSi55: raises 80 to 160
Caio Mugarte: folds 
Rosa885: folds 
deju501: folds 
Ziggyti: folds 
Kuanyin156: folds 
Tallir: folds 
Uncalled bet (80) returned to EnSi55
EnSi55 collected 270 from pot
EnSi55: doesn't show hand 
*** SUMMARY ***
Total pot 270 | Rake 0 
Seat 1: Ziggyti (button) folded before Flop (didn't bet)
Seat 2: Kuanyin156 (small blind) folded before Flop
Seat 3: Tallir (big blind) folded before Flop
Seat 5: EnSi55 collected (270)
Seat 7: Caio Mugarte folded before Flop (didn't bet)
Seat 8: Rosa885 folded before Flop (didn't bet)
Seat 9: deju501 folded before Flop (didn't bet)



PokerStars Hand #245425126077: Tournament #3632163743, $0.23+$0.02 USD Hold'em No Limit - Level IV (40/80) - 2023/08/16 14:39:51 AT [2023/08/16 13:39:51 ET]
Table '3632163743 5' 9-max Seat #2 is the button
Seat 1: Ziggyti (1124 in chips) 
Seat 2: Kuanyin156 (3879 in chips) 
Seat 3: Tallir (3013 in chips) 
Seat 5: EnSi55 (2493 in chips) 
Seat 7: Caio Mugarte (1551 in chips) 
Seat 8: Rosa885 (3874 in chips) 
Seat 9: deju501 (739 in chips) 
Ziggyti: posts the ante 10
Kuanyin156: posts the ante 10
Tallir: posts the ante 10
EnSi55: posts the ante 10
Caio Mugarte: posts the ante 10
Rosa885: posts the ante 10
deju501: posts the ante 10
Tallir: posts small blind 40
EnSi55: posts big blind 80
*** HOLE CARDS ***
Dealt to Caio Mugarte [6c 6d]
Caio Mugarte: raises 80 to 160
Rosa885: folds 
deju501: folds 
Ziggyti: folds 
Kuanyin156: calls 160
Tallir: folds 
EnSi55: calls 80
*** FLOP *** [Kh 4h Js]
EnSi55: checks 
Caio Mugarte: checks 
Kuanyin156: checks 
*** TURN *** [Kh 4h Js] [4d]
EnSi55: bets 80
Caio Mugarte: calls 80
Kuanyin156: calls 80
*** RIVER *** [Kh 4h Js 4d] [7h]
EnSi55: bets 80
Caio Mugarte: calls 80
Kuanyin156: folds 
*** SHOW DOWN ***
EnSi55: shows [Jh Kd] (two pair, Kings and Jacks)
Caio Mugarte: mucks hand 
EnSi55 collected 990 from pot
*** SUMMARY ***
Total pot 990 | Rake 0 
Board [Kh 4h Js 4d 7h]
Seat 1: Ziggyti folded before Flop (didn't bet)
Seat 2: Kuanyin156 (button) folded on the River
Seat 3: Tallir (small blind) folded before Flop
Seat 5: EnSi55 (big blind) showed [Jh Kd] and won (990) with two pair, Kings and Jacks
Seat 7: Caio Mugarte mucked [6c 6d]
Seat 8: Rosa885 folded before Flop (didn't bet)
Seat 9: deju501 folded before Flop (didn't bet)



PokerStars Hand #245425143797: Tournament #3632163743, $0.23+$0.02 USD Hold'em No Limit - Level IV (40/80) - 2023/08/16 14:40:54 AT [2023/08/16 13:40:54 ET]
Table '3632163743 5' 9-max Seat #3 is the button
Seat 1: Ziggyti (1114 in chips) 
Seat 2: Kuanyin156 (3629 in chips) 
Seat 3: Tallir (2963 in chips) 
Seat 5: EnSi55 (3153 in chips) 
Seat 7: Caio Mugarte (1221 in chips) 
Seat 8: Rosa885 (3864 in chips) 
Seat 9: deju501 (729 in chips) 
Ziggyti: posts the ante 10
Kuanyin156: posts the ante 10
Tallir: posts the ante 10
EnSi55: posts the ante 10
Caio Mugarte: posts the ante 10
Rosa885: posts the ante 10
deju501: posts the ante 10
EnSi55: posts small blind 40
Caio Mugarte: posts big blind 80
*** HOLE CARDS ***
Dealt to Caio Mugarte [7h Kd]
Rosa885: raises 96 to 176
deju501: calls 176
Ziggyti: folds 
Kuanyin156: calls 176
Tallir: folds 
EnSi55: folds 
Caio Mugarte: folds 
*** FLOP *** [9s 5c 6s]
Rosa885: checks 
deju501: bets 80
didyk59 is disconnected 
Kuanyin156: calls 80
Rosa885: calls 80
*** TURN *** [9s 5c 6s] [Qc]
Rosa885: checks 
deju501: checks 
Kuanyin156: checks 
*** RIVER *** [9s 5c 6s Qc] [3h]
Rosa885: bets 489
deju501: folds 
Kuanyin156: folds 
Uncalled bet (489) returned to Rosa885
Rosa885 collected 958 from pot
*** SUMMARY ***
Total pot 958 | Rake 0 
Board [9s 5c 6s Qc 3h]
Seat 1: Ziggyti folded before Flop (didn't bet)
Seat 2: Kuanyin156 folded on the River
Seat 3: Tallir (button) folded before Flop (didn't bet)
Seat 5: EnSi55 (small blind) folded before Flop
Seat 7: Caio Mugarte (big blind) folded before Flop
Seat 8: Rosa885 collected (958)
Seat 9: deju501 folded on the River



PokerStars Hand #245425161359: Tournament #3632163743, $0.23+$0.02 USD Hold'em No Limit - Level IV (40/80) - 2023/08/16 14:41:56 AT [2023/08/16 13:41:56 ET]
Table '3632163743 5' 9-max Seat #5 is the button
Seat 1: Ziggyti (1104 in chips) 
Seat 2: Kuanyin156 (3363 in chips) 
Seat 3: Tallir (2953 in chips) 
Seat 4: didyk59 (3244 in chips) 
Seat 5: EnSi55 (3103 in chips) 
Seat 6: Pipper13330 (339 in chips) out of hand (moved from another table into small blind)
Seat 7: Caio Mugarte (1131 in chips) 
Seat 8: Rosa885 (4556 in chips) 
Seat 9: deju501 (463 in chips) 
Pipper13330 will be allowed to play after the button
Ziggyti: posts the ante 10
Kuanyin156: posts the ante 10
Tallir: posts the ante 10
didyk59: posts the ante 10
EnSi55: posts the ante 10
Caio Mugarte: posts the ante 10
Rosa885: posts the ante 10
deju501: posts the ante 10
Caio Mugarte: posts small blind 40
Rosa885: posts big blind 80
*** HOLE CARDS ***
Dealt to Caio Mugarte [6h Jc]
deju501: raises 80 to 160
Ziggyti: folds 
Kuanyin156: calls 160
Tallir: folds 
didyk59: folds 
EnSi55: folds 
Caio Mugarte: folds 
Rosa885: folds 
*** FLOP *** [Ac Ad Jd]
deju501: checks 
Kuanyin156: bets 260
deju501: raises 33 to 293 and is all-in
Kuanyin156: calls 33
*** TURN *** [Ac Ad Jd] [Jh]
*** RIVER *** [Ac Ad Jd Jh] [7d]
*** SHOW DOWN ***
deju501: shows [Kh Th] (two pair, Aces and Jacks)
Kuanyin156: shows [4h Ks] (two pair, Aces and Jacks)
deju501 collected 553 from pot
Kuanyin156 collected 553 from pot
*** SUMMARY ***
Total pot 1106 | Rake 0 
Board [Ac Ad Jd Jh 7d]
Seat 1: Ziggyti folded before Flop (didn't bet)
Seat 2: Kuanyin156 showed [4h Ks] and won (553) with two pair, Aces and Jacks
Seat 3: Tallir folded before Flop (didn't bet)
Seat 4: didyk59 folded before Flop (didn't bet)
Seat 5: EnSi55 (button) folded before Flop (didn't bet)
Seat 7: Caio Mugarte (small blind) folded before Flop
Seat 8: Rosa885 (big blind) folded before Flop
Seat 9: deju501 showed [Kh Th] and won (553) with two pair, Aces and Jacks



PokerStars Hand #245425174610: Tournament #3632163743, $0.23+$0.02 USD Hold'em No Limit - Level IV (40/80) - 2023/08/16 14:42:44 AT [2023/08/16 13:42:44 ET]
Table '3632163743 5' 9-max Seat #7 is the button
Seat 1: Ziggyti (1094 in chips) 
Seat 2: Kuanyin156 (3453 in chips) 
Seat 3: Tallir (2943 in chips) 
Seat 4: didyk59 (3234 in chips) 
Seat 5: EnSi55 (3093 in chips) 
Seat 6: Pipper13330 (339 in chips) 
Seat 7: Caio Mugarte (1081 in chips) 
Seat 8: Rosa885 (4466 in chips) 
Seat 9: deju501 (553 in chips) 
Ziggyti: posts the ante 10
Kuanyin156: posts the ante 10
Tallir: posts the ante 10
didyk59: posts the ante 10
EnSi55: posts the ante 10
Pipper13330: posts the ante 10
Caio Mugarte: posts the ante 10
Rosa885: posts the ante 10
deju501: posts the ante 10
Rosa885: posts small blind 40
deju501: posts big blind 80
*** HOLE CARDS ***
Dealt to Caio Mugarte [2s 6h]
Ziggyti: folds 
Kuanyin156: calls 80
Tallir: folds 
didyk59: folds 
EnSi55: folds 
Pipper13330: calls 80
Caio Mugarte: folds 
Rosa885: calls 40
deju501: checks 
*** FLOP *** [Ks 5s 5h]
Rosa885: checks 
deju501: checks 
Kuanyin156: bets 205
Pipper13330: folds 
Rosa885: calls 205
deju501: folds 
*** TURN *** [Ks 5s 5h] [3c]
Rosa885: checks 
Kuanyin156: bets 160
Rosa885: calls 160
*** RIVER *** [Ks 5s 5h 3c] [6s]
Rosa885: bets 581
Pipper13330 is disconnected 
Kuanyin156 has timed out
Kuanyin156: folds 
Kuanyin156 is sitting out
Uncalled bet (581) returned to Rosa885
Rosa885 collected 1140 from pot
*** SUMMARY ***
Total pot 1140 | Rake 0 
Board [Ks 5s 5h 3c 6s]
Seat 1: Ziggyti folded before Flop (didn't bet)
Seat 2: Kuanyin156 folded on the River
Seat 3: Tallir folded before Flop (didn't bet)
Seat 4: didyk59 folded before Flop (didn't bet)
Seat 5: EnSi55 folded before Flop (didn't bet)
Seat 6: Pipper13330 folded on the Flop
Seat 7: Caio Mugarte (button) folded before Flop (didn't bet)
Seat 8: Rosa885 (small blind) collected (1140)
Seat 9: deju501 (big blind) folded on the Flop



PokerStars Hand #245425199967: Tournament #3632163743, $0.23+$0.02 USD Hold'em No Limit - Level IV (40/80) - 2023/08/16 14:44:15 AT [2023/08/16 13:44:15 ET]
Table '3632163743 5' 9-max Seat #8 is the button
Seat 1: Ziggyti (1084 in chips) 
Seat 3: Tallir (2933 in chips) 
Seat 4: didyk59 (3224 in chips) 
Seat 5: EnSi55 (3083 in chips) 
Seat 6: Pipper13330 (249 in chips) 
Seat 7: Caio Mugarte (1071 in chips) 
Seat 8: Rosa885 (5151 in chips) 
Seat 9: deju501 (463 in chips) 
Ziggyti: posts the ante 10
Tallir: posts the ante 10
didyk59: posts the ante 10
EnSi55: posts the ante 10
Pipper13330: posts the ante 10
Caio Mugarte: posts the ante 10
Rosa885: posts the ante 10
deju501: posts the ante 10
deju501: posts small blind 40
Ziggyti: posts big blind 80
*** HOLE CARDS ***
Dealt to Caio Mugarte [Kd 4h]
Tallir: folds 
didyk59: folds 
EnSi55: folds 
Pipper13330 has timed out while disconnected
Pipper13330: folds 
Pipper13330 is sitting out
Caio Mugarte: folds 
Rosa885: folds 
deju501: folds 
Uncalled bet (40) returned to Ziggyti
Ziggyti collected 160 from pot
*** SUMMARY ***
Total pot 160 | Rake 0 
Seat 1: Ziggyti (big blind) collected (160)
Seat 3: Tallir folded before Flop (didn't bet)
Seat 4: didyk59 folded before Flop (didn't bet)
Seat 5: EnSi55 folded before Flop (didn't bet)
Seat 6: Pipper13330 folded before Flop (didn't bet)
Seat 7: Caio Mugarte folded before Flop (didn't bet)
Seat 8: Rosa885 (button) folded before Flop (didn't bet)
Seat 9: deju501 (small blind) folded before Flop



PokerStars Hand #245425208102: Tournament #3632163743, $0.23+$0.02 USD Hold'em No Limit - Level IV (40/80) - 2023/08/16 14:44:44 AT [2023/08/16 13:44:44 ET]
Table '3632163743 5' 9-max Seat #9 is the button
Seat 1: Ziggyti (1194 in chips) 
Seat 3: Tallir (2923 in chips) 
Seat 4: didyk59 (3214 in chips) 
Seat 5: EnSi55 (3073 in chips) 
Seat 6: Pipper13330 (239 in chips) is sitting out
Seat 7: Caio Mugarte (1061 in chips) 
Seat 8: Rosa885 (5141 in chips) 
Seat 9: deju501 (413 in chips) 
Ziggyti: posts the ante 10
Tallir: posts the ante 10
didyk59: posts the ante 10
EnSi55: posts the ante 10
Pipper13330: posts the ante 10
Caio Mugarte: posts the ante 10
Rosa885: posts the ante 10
deju501: posts the ante 10
Ziggyti: posts small blind 40
Tallir: posts big blind 80
*** HOLE CARDS ***
Dealt to Caio Mugarte [9c Jh]
didyk59: folds 
EnSi55: folds 
Pipper13330: folds 
Caio Mugarte: folds 
Rosa885: folds 
deju501: folds 
Ziggyti: raises 80 to 160
Tallir: folds 
Uncalled bet (80) returned to Ziggyti
Ziggyti collected 240 from pot
*** SUMMARY ***
Total pot 240 | Rake 0 
Seat 1: Ziggyti (small blind) collected (240)
Seat 3: Tallir (big blind) folded before Flop
Seat 4: didyk59 folded before Flop (didn't bet)
Seat 5: EnSi55 folded before Flop (didn't bet)
Seat 6: Pipper13330 folded before Flop (didn't bet)
Seat 7: Caio Mugarte folded before Flop (didn't bet)
Seat 8: Rosa885 folded before Flop (didn't bet)
Seat 9: deju501 (button) folded before Flop (didn't bet)



PokerStars Hand #245425212683: Tournament #3632163743, $0.23+$0.02 USD Hold'em No Limit - Level IV (40/80) - 2023/08/16 14:45:00 AT [2023/08/16 13:45:00 ET]
Table '3632163743 5' 9-max Seat #1 is the button
Seat 1: Ziggyti (1344 in chips) 
Seat 3: Tallir (2833 in chips) 
Seat 4: didyk59 (3204 in chips) 
Seat 5: EnSi55 (3063 in chips) 
Seat 6: Pipper13330 (229 in chips) is sitting out
Seat 7: Caio Mugarte (1051 in chips) 
Seat 8: Rosa885 (5131 in chips) 
Seat 9: deju501 (403 in chips) 
Ziggyti: posts the ante 10
Tallir: posts the ante 10
didyk59: posts the ante 10
EnSi55: posts the ante 10
Pipper13330: posts the ante 10
Caio Mugarte: posts the ante 10
Rosa885: posts the ante 10
deju501: posts the ante 10
Tallir: posts small blind 40
didyk59: posts big blind 80
*** HOLE CARDS ***
Dealt to Caio Mugarte [8s 7d]
EnSi55: folds 
Pipper13330: folds 
Caio Mugarte: folds 
Rosa885: folds 
deju501: folds 
Ziggyti: folds 
Tallir: calls 40
didyk59: checks 
*** FLOP *** [8d Kh 3d]
Tallir: checks 
didyk59: checks 
*** TURN *** [8d Kh 3d] [4s]
Tallir: checks 
didyk59: checks 
*** RIVER *** [8d Kh 3d 4s] [7s]
Tallir: checks 
didyk59: checks 
*** SHOW DOWN ***
Tallir: shows [Qc Jd] (high card King)
didyk59: shows [7c 9h] (a pair of Sevens)
didyk59 collected 240 from pot
*** SUMMARY ***
Total pot 240 | Rake 0 
Board [8d Kh 3d 4s 7s]
Seat 1: Ziggyti (button) folded before Flop (didn't bet)
Seat 3: Tallir (small blind) showed [Qc Jd] and lost with high card King
Seat 4: didyk59 (big blind) showed [7c 9h] and won (240) with a pair of Sevens
Seat 5: EnSi55 folded before Flop (didn't bet)
Seat 6: Pipper13330 folded before Flop (didn't bet)
Seat 7: Caio Mugarte folded before Flop (didn't bet)
Seat 8: Rosa885 folded before Flop (didn't bet)
Seat 9: deju501 folded before Flop (didn't bet)



PokerStars Hand #245425223771: Tournament #3632163743, $0.23+$0.02 USD Hold'em No Limit - Level IV (40/80) - 2023/08/16 14:45:40 AT [2023/08/16 13:45:40 ET]
Table '3632163743 5' 9-max Seat #3 is the button
Seat 1: Ziggyti (1334 in chips) 
Seat 3: Tallir (2743 in chips) 
Seat 4: didyk59 (3354 in chips) 
Seat 5: EnSi55 (3053 in chips) 
Seat 6: Pipper13330 (219 in chips) is sitting out
Seat 7: Caio Mugarte (1041 in chips) 
Seat 8: Rosa885 (5121 in chips) 
Seat 9: deju501 (393 in chips) 
Ziggyti: posts the ante 10
Tallir: posts the ante 10
didyk59: posts the ante 10
EnSi55: posts the ante 10
Pipper13330: posts the ante 10
Caio Mugarte: posts the ante 10
Rosa885: posts the ante 10
deju501: posts the ante 10
didyk59: posts small blind 40
EnSi55: posts big blind 80
*** HOLE CARDS ***
Dealt to Caio Mugarte [As Ks]
Pipper13330: folds 
Caio Mugarte: raises 951 to 1031 and is all-in
Rosa885: folds 
deju501: folds 
Ziggyti: folds 
Tallir: folds 
didyk59: folds 
EnSi55: folds 
Uncalled bet (951) returned to Caio Mugarte
Caio Mugarte collected 280 from pot
Caio Mugarte: doesn't show hand 
*** SUMMARY ***
Total pot 280 | Rake 0 
Seat 1: Ziggyti folded before Flop (didn't bet)
Seat 3: Tallir (button) folded before Flop (didn't bet)
Seat 4: didyk59 (small blind) folded before Flop
Seat 5: EnSi55 (big blind) folded before Flop
Seat 6: Pipper13330 folded before Flop (didn't bet)
Seat 7: Caio Mugarte collected (280)
Seat 8: Rosa885 folded before Flop (didn't bet)
Seat 9: deju501 folded before Flop (didn't bet)



PokerStars Hand #245425229484: Tournament #3632163743, $0.23+$0.02 USD Hold'em No Limit - Level IV (40/80) - 2023/08/16 14:46:00 AT [2023/08/16 13:46:00 ET]
Table '3632163743 5' 9-max Seat #4 is the button
Seat 1: Ziggyti (1324 in chips) 
Seat 3: Tallir (2733 in chips) 
Seat 4: didyk59 (3304 in chips) 
Seat 5: EnSi55 (2963 in chips) 
Seat 6: Pipper13330 (209 in chips) is sitting out
Seat 7: Caio Mugarte (1231 in chips) 
Seat 8: Rosa885 (5111 in chips) 
Seat 9: deju501 (383 in chips) 
Ziggyti: posts the ante 10
Tallir: posts the ante 10
didyk59: posts the ante 10
EnSi55: posts the ante 10
Pipper13330: posts the ante 10
Caio Mugarte: posts the ante 10
Rosa885: posts the ante 10
deju501: posts the ante 10
EnSi55: posts small blind 40
Pipper13330: posts big blind 80
*** HOLE CARDS ***
Dealt to Caio Mugarte [Ks 9d]
Caio Mugarte: folds 
Rosa885: folds 
deju501: folds 
Ziggyti: folds 
Tallir: folds 
didyk59: raises 80 to 160
EnSi55: calls 120
Pipper13330: folds 
*** FLOP *** [8h Jh Js]
EnSi55: checks 
didyk59: bets 240
EnSi55: folds 
Uncalled bet (240) returned to didyk59
didyk59 collected 480 from pot
didyk59: doesn't show hand 
*** SUMMARY ***
Total pot 480 | Rake 0 
Board [8h Jh Js]
Seat 1: Ziggyti folded before Flop (didn't bet)
Seat 3: Tallir folded before Flop (didn't bet)
Seat 4: didyk59 (button) collected (480)
Seat 5: EnSi55 (small blind) folded on the Flop
Seat 6: Pipper13330 (big blind) folded before Flop
Seat 7: Caio Mugarte folded before Flop (didn't bet)
Seat 8: Rosa885 folded before Flop (didn't bet)
Seat 9: deju501 folded before Flop (didn't bet)



PokerStars Hand #245425241014: Tournament #3632163743, $0.23+$0.02 USD Hold'em No Limit - Level IV (40/80) - 2023/08/16 14:46:42 AT [2023/08/16 13:46:42 ET]
Table '3632163743 5' 9-max Seat #5 is the button
Seat 1: Ziggyti (1314 in chips) 
Seat 3: Tallir (2723 in chips) 
Seat 4: didyk59 (3614 in chips) 
Seat 5: EnSi55 (2793 in chips) 
Seat 6: Pipper13330 (119 in chips) is sitting out
Seat 7: Caio Mugarte (1221 in chips) 
Seat 8: Rosa885 (5101 in chips) 
Seat 9: deju501 (373 in chips) 
Ziggyti: posts the ante 10
Tallir: posts the ante 10
didyk59: posts the ante 10
EnSi55: posts the ante 10
Pipper13330: posts the ante 10
Caio Mugarte: posts the ante 10
Rosa885: posts the ante 10
deju501: posts the ante 10
Pipper13330: posts small blind 40
Caio Mugarte: posts big blind 80
*** HOLE CARDS ***
Dealt to Caio Mugarte [6d Js]
Rosa885: folds 
deju501: raises 283 to 363 and is all-in
Ziggyti: folds 
Tallir: folds 
didyk59: folds 
EnSi55: calls 363
Pipper13330: folds 
Caio Mugarte: folds 
*** FLOP *** [6h 2h Jc]
*** TURN *** [6h 2h Jc] [6s]
*** RIVER *** [6h 2h Jc 6s] [Ks]
*** SHOW DOWN ***
deju501: shows [Ah 9h] (a pair of Sixes)
EnSi55: shows [Qc Ac] (a pair of Sixes - Ace+King+Queen kicker)
EnSi55 collected 926 from pot
deju501 finished the tournament in 25th place
*** SUMMARY ***
Total pot 926 | Rake 0 
Board [6h 2h Jc 6s Ks]
Seat 1: Ziggyti folded before Flop (didn't bet)
Seat 3: Tallir folded before Flop (didn't bet)
Seat 4: didyk59 folded before Flop (didn't bet)
Seat 5: EnSi55 (button) showed [Qc Ac] and won (926) with a pair of Sixes
Seat 6: Pipper13330 (small blind) folded before Flop
Seat 7: Caio Mugarte (big blind) folded before Flop
Seat 8: Rosa885 folded before Flop (didn't bet)
Seat 9: deju501 showed [Ah 9h] and lost with a pair of Sixes



PokerStars Hand #245425248988: Tournament #3632163743, $0.23+$0.02 USD Hold'em No Limit - Level IV (40/80) - 2023/08/16 14:47:10 AT [2023/08/16 13:47:10 ET]
Table '3632163743 5' 9-max Seat #6 is the button
Seat 1: Ziggyti (1304 in chips) 
Seat 3: Tallir (2713 in chips) 
Seat 4: didyk59 (3604 in chips) 
Seat 5: EnSi55 (3346 in chips) 
Seat 6: Pipper13330 (69 in chips) is sitting out
Seat 7: Caio Mugarte (1131 in chips) 
Seat 8: Rosa885 (5091 in chips) 
Ziggyti: posts the ante 10
Tallir: posts the ante 10
didyk59: posts the ante 10
EnSi55: posts the ante 10
Pipper13330: posts the ante 10
Caio Mugarte: posts the ante 10
Rosa885: posts the ante 10
Caio Mugarte: posts small blind 40
Rosa885: posts big blind 80
*** HOLE CARDS ***
Dealt to Caio Mugarte [3s Tc]
Ziggyti: folds 
Tallir: folds 
didyk59: folds 
EnSi55: folds 
Pipper13330: folds 
Caio Mugarte: folds 
Uncalled bet (40) returned to Rosa885
Rosa885 collected 150 from pot
*** SUMMARY ***
Total pot 150 | Rake 0 
Seat 1: Ziggyti folded before Flop (didn't bet)
Seat 3: Tallir folded before Flop (didn't bet)
Seat 4: didyk59 folded before Flop (didn't bet)
Seat 5: EnSi55 folded before Flop (didn't bet)
Seat 6: Pipper13330 (button) folded before Flop (didn't bet)
Seat 7: Caio Mugarte (small blind) folded before Flop
Seat 8: Rosa885 (big blind) collected (150)



PokerStars Hand #245425252296: Tournament #3632163743, $0.23+$0.02 USD Hold'em No Limit - Level IV (40/80) - 2023/08/16 14:47:22 AT [2023/08/16 13:47:22 ET]
Table '3632163743 5' 9-max Seat #7 is the button
Seat 1: Ziggyti (1294 in chips) 
Seat 3: Tallir (2703 in chips) 
Seat 4: didyk59 (3594 in chips) 
Seat 5: EnSi55 (3336 in chips) 
Seat 6: Pipper13330 (59 in chips) is sitting out
Seat 7: Caio Mugarte (1081 in chips) 
Seat 8: Rosa885 (5191 in chips) 
Ziggyti: posts the ante 10
Tallir: posts the ante 10
didyk59: posts the ante 10
EnSi55: posts the ante 10
Pipper13330: posts the ante 10
Caio Mugarte: posts the ante 10
Rosa885: posts the ante 10
Rosa885: posts small blind 40
Ziggyti: posts big blind 80
*** HOLE CARDS ***
Dealt to Caio Mugarte [4d 2d]
Tallir: calls 80
didyk59: folds 
EnSi55: folds 
Pipper13330: folds 
Caio Mugarte: folds 
Rosa885: folds 
Ziggyti: raises 240 to 320
banane4711 is disconnected 
Tallir: folds 
Uncalled bet (240) returned to Ziggyti
Ziggyti collected 270 from pot
*** SUMMARY ***
Total pot 270 | Rake 0 
Seat 1: Ziggyti (big blind) collected (270)
Seat 3: Tallir folded before Flop
Seat 4: didyk59 folded before Flop (didn't bet)
Seat 5: EnSi55 folded before Flop (didn't bet)
Seat 6: Pipper13330 folded before Flop (didn't bet)
Seat 7: Caio Mugarte (button) folded before Flop (didn't bet)
Seat 8: Rosa885 (small blind) folded before Flop



PokerStars Hand #245425262875: Tournament #3632163743, $0.23+$0.02 USD Hold'em No Limit - Level IV (40/80) - 2023/08/16 14:48:00 AT [2023/08/16 13:48:00 ET]
Table '3632163743 5' 9-max Seat #8 is the button
Seat 1: Ziggyti (1474 in chips) 
Seat 2: banane4711 (2968 in chips) 
Seat 3: Tallir (2613 in chips) 
Seat 4: didyk59 (3584 in chips) 
Seat 5: EnSi55 (3326 in chips) 
Seat 6: Pipper13330 (49 in chips) is sitting out
Seat 7: Caio Mugarte (1071 in chips) 
Seat 8: Rosa885 (5141 in chips) 
Ziggyti: posts the ante 10
banane4711: posts the ante 10
Tallir: posts the ante 10
didyk59: posts the ante 10
EnSi55: posts the ante 10
Pipper13330: posts the ante 10
Caio Mugarte: posts the ante 10
Rosa885: posts the ante 10
Ziggyti: posts small blind 40
banane4711: posts big blind 80
*** HOLE CARDS ***
Dealt to Caio Mugarte [Kc 7h]
Tallir: folds 
didyk59: folds 
EnSi55: folds 
Pipper13330: folds 
Caio Mugarte: folds 
Rosa885: folds 
Ziggyti: folds 
Uncalled bet (40) returned to banane4711
banane4711 collected 160 from pot
banane4711: doesn't show hand 
*** SUMMARY ***
Total pot 160 | Rake 0 
Seat 1: Ziggyti (small blind) folded before Flop
Seat 2: banane4711 (big blind) collected (160)
Seat 3: Tallir folded before Flop (didn't bet)
Seat 4: didyk59 folded before Flop (didn't bet)
Seat 5: EnSi55 folded before Flop (didn't bet)
Seat 6: Pipper13330 folded before Flop (didn't bet)
Seat 7: Caio Mugarte folded before Flop (didn't bet)
Seat 8: Rosa885 (button) folded before Flop (didn't bet)



PokerStars Hand #245425267502: Tournament #3632163743, $0.23+$0.02 USD Hold'em No Limit - Level IV (40/80) - 2023/08/16 14:48:17 AT [2023/08/16 13:48:17 ET]
Table '3632163743 5' 9-max Seat #1 is the button
Seat 1: Ziggyti (1424 in chips) 
Seat 2: banane4711 (3078 in chips) 
Seat 3: Tallir (2603 in chips) 
Seat 4: didyk59 (3574 in chips) 
Seat 5: EnSi55 (3316 in chips) 
Seat 6: Pipper13330 (39 in chips) is sitting out
Seat 7: Caio Mugarte (1061 in chips) 
Seat 8: Rosa885 (5131 in chips) 
Ziggyti: posts the ante 10
banane4711: posts the ante 10
Tallir: posts the ante 10
didyk59: posts the ante 10
EnSi55: posts the ante 10
Pipper13330: posts the ante 10
Caio Mugarte: posts the ante 10
Rosa885: posts the ante 10
banane4711: posts small blind 40
Tallir: posts big blind 80
*** HOLE CARDS ***
Dealt to Caio Mugarte [3h 2d]
didyk59: raises 80 to 160
EnSi55: folds 
Pipper13330: folds 
Caio Mugarte: folds 
Rosa885: folds 
Ziggyti: calls 160
banane4711: folds 
Tallir: calls 80
*** FLOP *** [Js 7h 3c]
Tallir: checks 
didyk59: bets 80
Ziggyti: raises 240 to 320
Tallir: folds 
didyk59: folds 
Uncalled bet (240) returned to Ziggyti
Ziggyti collected 760 from pot
*** SUMMARY ***
Total pot 760 | Rake 0 
Board [Js 7h 3c]
Seat 1: Ziggyti (button) collected (760)
Seat 2: banane4711 (small blind) folded before Flop
Seat 3: Tallir (big blind) folded on the Flop
Seat 4: didyk59 folded on the Flop
Seat 5: EnSi55 folded before Flop (didn't bet)
Seat 6: Pipper13330 folded before Flop (didn't bet)
Seat 7: Caio Mugarte folded before Flop (didn't bet)
Seat 8: Rosa885 folded before Flop (didn't bet)



PokerStars Hand #245425278685: Tournament #3632163743, $0.23+$0.02 USD Hold'em No Limit - Level IV (40/80) - 2023/08/16 14:48:57 AT [2023/08/16 13:48:57 ET]
Table '3632163743 5' 9-max Seat #2 is the button
Seat 1: Ziggyti (1934 in chips) 
Seat 2: banane4711 (3028 in chips) 
Seat 3: Tallir (2433 in chips) 
Seat 4: didyk59 (3324 in chips) 
Seat 5: EnSi55 (3306 in chips) 
Seat 6: Pipper13330 (29 in chips) is sitting out
Seat 7: Caio Mugarte (1051 in chips) 
Seat 8: Rosa885 (5121 in chips) 
Ziggyti: posts the ante 10
banane4711: posts the ante 10
Tallir: posts the ante 10
didyk59: posts the ante 10
EnSi55: posts the ante 10
Pipper13330: posts the ante 10
Caio Mugarte: posts the ante 10
Rosa885: posts the ante 10
Tallir: posts small blind 40
didyk59: posts big blind 80
*** HOLE CARDS ***
Dealt to Caio Mugarte [5h Qh]
EnSi55: folds 
Pipper13330: folds 
Caio Mugarte: folds 
Rosa885: raises 80 to 160
Ziggyti: folds 
banane4711: raises 2858 to 3018 and is all-in
Tallir: folds 
didyk59: folds 
Rosa885: folds 
Uncalled bet (2858) returned to banane4711
banane4711 collected 520 from pot
banane4711: doesn't show hand 
*** SUMMARY ***
Total pot 520 | Rake 0 
Seat 1: Ziggyti folded before Flop (didn't bet)
Seat 2: banane4711 (button) collected (520)
Seat 3: Tallir (small blind) folded before Flop
Seat 4: didyk59 (big blind) folded before Flop
Seat 5: EnSi55 folded before Flop (didn't bet)
Seat 6: Pipper13330 folded before Flop (didn't bet)
Seat 7: Caio Mugarte folded before Flop (didn't bet)
Seat 8: Rosa885 folded before Flop



PokerStars Hand #245425285031: Tournament #3632163743, $0.23+$0.02 USD Hold'em No Limit - Level V (60/120) - 2023/08/16 14:49:19 AT [2023/08/16 13:49:19 ET]
Table '3632163743 5' 9-max Seat #3 is the button
Seat 1: Ziggyti (1924 in chips) 
Seat 2: banane4711 (3378 in chips) 
Seat 3: Tallir (2383 in chips) 
Seat 4: didyk59 (3234 in chips) 
Seat 5: EnSi55 (3296 in chips) 
Seat 6: Pipper13330 (19 in chips) is sitting out
Seat 7: Caio Mugarte (1041 in chips) 
Seat 8: Rosa885 (4951 in chips) 
Ziggyti: posts the ante 15
banane4711: posts the ante 15
Tallir: posts the ante 15
didyk59: posts the ante 15
EnSi55: posts the ante 15
Pipper13330: posts the ante 15
Caio Mugarte: posts the ante 15
Rosa885: posts the ante 15
didyk59: posts small blind 60
EnSi55: posts big blind 120
*** HOLE CARDS ***
Dealt to Caio Mugarte [Ad Ks]
Pipper13330: folds 
Caio Mugarte: raises 906 to 1026 and is all-in
Rosa885: folds 
Ziggyti: folds 
banane4711: folds 
Tallir: folds 
didyk59: folds 
EnSi55: folds 
Uncalled bet (906) returned to Caio Mugarte
Caio Mugarte collected 420 from pot
Caio Mugarte: doesn't show hand 
*** SUMMARY ***
Total pot 420 | Rake 0 
Seat 1: Ziggyti folded before Flop (didn't bet)
Seat 2: banane4711 folded before Flop (didn't bet)
Seat 3: Tallir (button) folded before Flop (didn't bet)
Seat 4: didyk59 (small blind) folded before Flop
Seat 5: EnSi55 (big blind) folded before Flop
Seat 6: Pipper13330 folded before Flop (didn't bet)
Seat 7: Caio Mugarte collected (420)
Seat 8: Rosa885 folded before Flop (didn't bet)



PokerStars Hand #245425291497: Tournament #3632163743, $0.23+$0.02 USD Hold'em No Limit - Level V (60/120) - 2023/08/16 14:49:43 AT [2023/08/16 13:49:43 ET]
Table '3632163743 5' 9-max Seat #4 is the button
Seat 1: Ziggyti (1909 in chips) 
Seat 2: banane4711 (3363 in chips) 
Seat 3: Tallir (2368 in chips) 
Seat 4: didyk59 (3159 in chips) 
Seat 5: EnSi55 (3161 in chips) 
Seat 6: Pipper13330 (4 in chips) is sitting out
Seat 7: Caio Mugarte (1326 in chips) 
Seat 8: Rosa885 (4936 in chips) 
Ziggyti: posts the ante 15
banane4711: posts the ante 15
Tallir: posts the ante 15
didyk59: posts the ante 15
EnSi55: posts the ante 15
Pipper13330: posts the ante 4 and is all-in
Caio Mugarte: posts the ante 15
Rosa885: posts the ante 15
EnSi55: posts small blind 60
*** HOLE CARDS ***
Dealt to Caio Mugarte [Ad 7c]
Caio Mugarte: folds 
Rosa885: folds 
Ziggyti: raises 180 to 240
banane4711: folds 
Tallir: folds 
didyk59: folds 
EnSi55: raises 180 to 420
Pipper13330: folds 
Ziggyti: calls 180
*** FLOP *** [5d Qs Js]
EnSi55: checks 
Ziggyti: checks 
*** TURN *** [5d Qs Js] [4c]
EnSi55: bets 949
Ziggyti: folds 
Uncalled bet (949) returned to EnSi55
EnSi55 collected 949 from pot
Pipper13330 finished the tournament in 21st place
EnSi55: doesn't show hand 
*** SUMMARY ***
Total pot 949 | Rake 0 
Board [5d Qs Js 4c]
Seat 1: Ziggyti folded on the Turn
Seat 2: banane4711 folded before Flop (didn't bet)
Seat 3: Tallir folded before Flop (didn't bet)
Seat 4: didyk59 (button) folded before Flop (didn't bet)
Seat 5: EnSi55 (small blind) collected (949)
Seat 6: Pipper13330 folded before Flop (didn't bet)
Seat 7: Caio Mugarte folded before Flop (didn't bet)
Seat 8: Rosa885 folded before Flop (didn't bet)



PokerStars Hand #245425308402: Tournament #3632163743, $0.23+$0.02 USD Hold'em No Limit - Level V (60/120) - 2023/08/16 14:50:43 AT [2023/08/16 13:50:43 ET]
Table '3632163743 5' 9-max Seat #5 is the button
Seat 1: Ziggyti (1474 in chips) 
Seat 2: banane4711 (3348 in chips) 
Seat 3: Tallir (2353 in chips) 
Seat 4: didyk59 (3144 in chips) 
Seat 5: EnSi55 (3675 in chips) 
Seat 7: Caio Mugarte (1311 in chips) 
Seat 8: Rosa885 (4921 in chips) 
Ziggyti: posts the ante 15
banane4711: posts the ante 15
Tallir: posts the ante 15
didyk59: posts the ante 15
EnSi55: posts the ante 15
Caio Mugarte: posts the ante 15
Rosa885: posts the ante 15
Caio Mugarte: posts small blind 60
Rosa885: posts big blind 120
*** HOLE CARDS ***
Dealt to Caio Mugarte [Ts 2s]
Ziggyti: folds 
banane4711: folds 
Tallir: calls 120
didyk59: folds 
EnSi55: folds 
Caio Mugarte: calls 60
Rosa885: checks 
*** FLOP *** [6s 8h 7c]
Caio Mugarte: checks 
Rosa885: checks 
Tallir: checks 
*** TURN *** [6s 8h 7c] [3d]
Caio Mugarte: checks 
Rosa885: checks 
Tallir: bets 120
Caio Mugarte: folds 
Rosa885: folds 
Uncalled bet (120) returned to Tallir
Tallir collected 465 from pot
*** SUMMARY ***
Total pot 465 | Rake 0 
Board [6s 8h 7c 3d]
Seat 1: Ziggyti folded before Flop (didn't bet)
Seat 2: banane4711 folded before Flop (didn't bet)
Seat 3: Tallir collected (465)
Seat 4: didyk59 folded before Flop (didn't bet)
Seat 5: EnSi55 (button) folded before Flop (didn't bet)
Seat 7: Caio Mugarte (small blind) folded on the Turn
Seat 8: Rosa885 (big blind) folded on the Turn



PokerStars Hand #245425322443: Tournament #3632163743, $0.23+$0.02 USD Hold'em No Limit - Level V (60/120) - 2023/08/16 14:51:34 AT [2023/08/16 13:51:34 ET]
Table '3632163743 5' 9-max Seat #7 is the button
Seat 1: Ziggyti (1459 in chips) 
Seat 2: banane4711 (3333 in chips) 
Seat 3: Tallir (2683 in chips) 
Seat 4: didyk59 (3129 in chips) 
Seat 5: EnSi55 (3660 in chips) 
Seat 7: Caio Mugarte (1176 in chips) 
Seat 8: Rosa885 (4786 in chips) 
Ziggyti: posts the ante 15
banane4711: posts the ante 15
Tallir: posts the ante 15
didyk59: posts the ante 15
EnSi55: posts the ante 15
Caio Mugarte: posts the ante 15
Rosa885: posts the ante 15
Rosa885: posts small blind 60
Ziggyti: posts big blind 120
*** HOLE CARDS ***
Dealt to Caio Mugarte [Th 9c]
banane4711: calls 120
Tallir: folds 
didyk59: folds 
EnSi55: folds 
Caio Mugarte: folds 
Rosa885: folds 
Ziggyti: checks 
*** FLOP *** [Jd 7c Ac]
Ziggyti: checks 
banane4711: bets 203
Ziggyti: folds 
Uncalled bet (203) returned to banane4711
banane4711 collected 405 from pot
banane4711: doesn't show hand 
*** SUMMARY ***
Total pot 405 | Rake 0 
Board [Jd 7c Ac]
Seat 1: Ziggyti (big blind) folded on the Flop
Seat 2: banane4711 collected (405)
Seat 3: Tallir folded before Flop (didn't bet)
Seat 4: didyk59 folded before Flop (didn't bet)
Seat 5: EnSi55 folded before Flop (didn't bet)
Seat 7: Caio Mugarte (button) folded before Flop (didn't bet)
Seat 8: Rosa885 (small blind) folded before Flop



PokerStars Hand #245425330101: Tournament #3632163743, $0.23+$0.02 USD Hold'em No Limit - Level V (60/120) - 2023/08/16 14:52:01 AT [2023/08/16 13:52:01 ET]
Table '3632163743 5' 9-max Seat #8 is the button
Seat 1: Ziggyti (1324 in chips) 
Seat 2: banane4711 (3603 in chips) 
Seat 3: Tallir (2668 in chips) 
Seat 4: didyk59 (3114 in chips) 
Seat 5: EnSi55 (3645 in chips) 
Seat 7: Caio Mugarte (1161 in chips) 
Seat 8: Rosa885 (4711 in chips) 
Ziggyti: posts the ante 15
banane4711: posts the ante 15
Tallir: posts the ante 15
didyk59: posts the ante 15
EnSi55: posts the ante 15
Caio Mugarte: posts the ante 15
Rosa885: posts the ante 15
Ziggyti: posts small blind 60
banane4711: posts big blind 120
*** HOLE CARDS ***
Dealt to Caio Mugarte [Tc 8c]
Tallir: calls 120
didyk59: folds 
EnSi55: folds 
Caio Mugarte: folds 
Rosa885: folds 
Ziggyti: folds 
banane4711: checks 
*** FLOP *** [4s Ts 7d]
banane4711: checks 
Tallir: checks 
*** TURN *** [4s Ts 7d] [5d]
banane4711: checks 
Tallir: checks 
*** RIVER *** [4s Ts 7d 5d] [2h]
banane4711: checks 
Tallir: bets 240
banane4711: folds 
Uncalled bet (240) returned to Tallir
Tallir collected 405 from pot
*** SUMMARY ***
Total pot 405 | Rake 0 
Board [4s Ts 7d 5d 2h]
Seat 1: Ziggyti (small blind) folded before Flop
Seat 2: banane4711 (big blind) folded on the River
Seat 3: Tallir collected (405)
Seat 4: didyk59 folded before Flop (didn't bet)
Seat 5: EnSi55 folded before Flop (didn't bet)
Seat 7: Caio Mugarte folded before Flop (didn't bet)
Seat 8: Rosa885 (button) folded before Flop (didn't bet)



PokerStars Hand #245425349509: Tournament #3632163743, $0.23+$0.02 USD Hold'em No Limit - Level V (60/120) - 2023/08/16 14:53:11 AT [2023/08/16 13:53:11 ET]
Table '3632163743 5' 9-max Seat #1 is the button
Seat 1: Ziggyti (1249 in chips) 
Seat 2: banane4711 (3468 in chips) 
Seat 3: Tallir (2938 in chips) 
Seat 4: didyk59 (3099 in chips) 
Seat 5: EnSi55 (3630 in chips) 
Seat 7: Caio Mugarte (1146 in chips) 
Seat 8: Rosa885 (4696 in chips) 
Ziggyti: posts the ante 15
banane4711: posts the ante 15
Tallir: posts the ante 15
didyk59: posts the ante 15
EnSi55: posts the ante 15
Caio Mugarte: posts the ante 15
Rosa885: posts the ante 15
banane4711: posts small blind 60
Tallir: posts big blind 120
*** HOLE CARDS ***
Dealt to Caio Mugarte [8s 8c]
didyk59: folds 
EnSi55: calls 120
Caio Mugarte: raises 1011 to 1131 and is all-in
Rosa885: folds 
Ziggyti: folds 
banane4711: folds 
Tallir: folds 
EnSi55: calls 1011
*** FLOP *** [Td 2s 8d]
*** TURN *** [Td 2s 8d] [9h]
*** RIVER *** [Td 2s 8d 9h] [5d]
*** SHOW DOWN ***
EnSi55: shows [3s 3d] (a pair of Threes)
Caio Mugarte: shows [8s 8c] (three of a kind, Eights)
Caio Mugarte collected 2547 from pot
*** SUMMARY ***
Total pot 2547 | Rake 0 
Board [Td 2s 8d 9h 5d]
Seat 1: Ziggyti (button) folded before Flop (didn't bet)
Seat 2: banane4711 (small blind) folded before Flop
Seat 3: Tallir (big blind) folded before Flop
Seat 4: didyk59 folded before Flop (didn't bet)
Seat 5: EnSi55 showed [3s 3d] and lost with a pair of Threes
Seat 7: Caio Mugarte showed [8s 8c] and won (2547) with three of a kind, Eights
Seat 8: Rosa885 folded before Flop (didn't bet)



PokerStars Hand #245425358723: Tournament #3632163743, $0.23+$0.02 USD Hold'em No Limit - Level V (60/120) - 2023/08/16 14:53:44 AT [2023/08/16 13:53:44 ET]
Table '3632163743 5' 9-max Seat #2 is the button
Seat 1: Ziggyti (1234 in chips) 
Seat 2: banane4711 (3393 in chips) 
Seat 3: Tallir (2803 in chips) 
Seat 4: didyk59 (3084 in chips) 
Seat 5: EnSi55 (2484 in chips) 
Seat 7: Caio Mugarte (2547 in chips) 
Seat 8: Rosa885 (4681 in chips) 
Ziggyti: posts the ante 15
banane4711: posts the ante 15
Tallir: posts the ante 15
didyk59: posts the ante 15
EnSi55: posts the ante 15
Caio Mugarte: posts the ante 15
Rosa885: posts the ante 15
Tallir: posts small blind 60
didyk59: posts big blind 120
*** HOLE CARDS ***
Dealt to Caio Mugarte [4d Ks]
EnSi55: folds 
Caio Mugarte: folds 
Rosa885: folds 
Ziggyti: raises 120 to 240
banane4711: folds 
Tallir: folds 
didyk59: raises 2829 to 3069 and is all-in
Ziggyti: calls 979 and is all-in
Uncalled bet (1850) returned to didyk59
*** FLOP *** [4h 7s 8d]
*** TURN *** [4h 7s 8d] [5c]
*** RIVER *** [4h 7s 8d 5c] [9d]
*** SHOW DOWN ***
didyk59: shows [7d 7c] (three of a kind, Sevens)
Ziggyti: shows [Ts 6s] (a straight, Six to Ten)
Ziggyti collected 2603 from pot
*** SUMMARY ***
Total pot 2603 | Rake 0 
Board [4h 7s 8d 5c 9d]
Seat 1: Ziggyti showed [Ts 6s] and won (2603) with a straight, Six to Ten
Seat 2: banane4711 (button) folded before Flop (didn't bet)
Seat 3: Tallir (small blind) folded before Flop
Seat 4: didyk59 (big blind) showed [7d 7c] and lost with three of a kind, Sevens
Seat 5: EnSi55 folded before Flop (didn't bet)
Seat 7: Caio Mugarte folded before Flop (didn't bet)
Seat 8: Rosa885 folded before Flop (didn't bet)



PokerStars Hand #245425371178: Tournament #3632163743, $0.23+$0.02 USD Hold'em No Limit - Level V (60/120) - 2023/08/16 14:54:29 AT [2023/08/16 13:54:29 ET]
Table '3632163743 5' 9-max Seat #3 is the button
Seat 1: Ziggyti (2603 in chips) 
Seat 2: banane4711 (3378 in chips) 
Seat 3: Tallir (2728 in chips) 
Seat 4: didyk59 (1850 in chips) 
Seat 5: EnSi55 (2469 in chips) 
Seat 7: Caio Mugarte (2532 in chips) 
Seat 8: Rosa885 (4666 in chips) 
Ziggyti: posts the ante 15
banane4711: posts the ante 15
Tallir: posts the ante 15
didyk59: posts the ante 15
EnSi55: posts the ante 15
Caio Mugarte: posts the ante 15
Rosa885: posts the ante 15
didyk59: posts small blind 60
EnSi55: posts big blind 120
*** HOLE CARDS ***
Dealt to Caio Mugarte [Qs 4c]
Caio Mugarte: folds 
Rosa885: folds 
Ziggyti: raises 120 to 240
banane4711: raises 720 to 960
Tallir: folds 
didyk59: folds 
EnSi55: folds 
Ziggyti: calls 720
*** FLOP *** [2s Td Ts]
Kuanyin156 is disconnected 
MMdubaralho is disconnected 
Ziggyti: checks 
banane4711: bets 1654
Ziggyti: calls 1628 and is all-in
Uncalled bet (26) returned to banane4711
*** TURN *** [2s Td Ts] [6c]
*** RIVER *** [2s Td Ts 6c] [2h]
*** SHOW DOWN ***
Ziggyti: shows [9h 9s] (two pair, Tens and Nines)
banane4711: shows [Ac Ad] (two pair, Aces and Tens)
banane4711 collected 5461 from pot
Ziggyti finished the tournament in 18th place
*** SUMMARY ***
Total pot 5461 | Rake 0 
Board [2s Td Ts 6c 2h]
Seat 1: Ziggyti showed [9h 9s] and lost with two pair, Tens and Nines
Seat 2: banane4711 showed [Ac Ad] and won (5461) with two pair, Aces and Tens
Seat 3: Tallir (button) folded before Flop (didn't bet)
Seat 4: didyk59 (small blind) folded before Flop
Seat 5: EnSi55 (big blind) folded before Flop
Seat 7: Caio Mugarte folded before Flop (didn't bet)
Seat 8: Rosa885 folded before Flop (didn't bet)



PokerStars Hand #245425446282: Tournament #3632163743, $0.23+$0.02 USD Hold'em No Limit - Level V (60/120) - 2023/08/16 15:00:08 AT [2023/08/16 14:00:08 ET]
Table '3632163743 5' 9-max Seat #4 is the button
Seat 2: banane4711 (6236 in chips) 
Seat 3: Tallir (2713 in chips) 
Seat 4: didyk59 (1775 in chips) 
Seat 5: EnSi55 (2334 in chips) 
Seat 6: MMdubaralho (3661 in chips) 
Seat 7: Caio Mugarte (2517 in chips) 
Seat 8: Rosa885 (4651 in chips) 
Seat 9: Kuanyin156 (2503 in chips) 
banane4711: posts the ante 15
Tallir: posts the ante 15
didyk59: posts the ante 15
EnSi55: posts the ante 15
MMdubaralho: posts the ante 15
Caio Mugarte: posts the ante 15
Rosa885: posts the ante 15
Kuanyin156: posts the ante 15
EnSi55: posts small blind 60
MMdubaralho: posts big blind 120
*** HOLE CARDS ***
Dealt to Caio Mugarte [As Qd]
Caio Mugarte: raises 120 to 240
Rosa885: calls 240
Kuanyin156: folds 
banane4711 has timed out
banane4711: folds 
banane4711 is sitting out
Tallir: folds 
didyk59: folds 
EnSi55: calls 180
MMdubaralho: calls 120
*** FLOP *** [Ah 9c 5h]
EnSi55: checks 
MMdubaralho: checks 
Caio Mugarte: bets 356
Rosa885: folds 
EnSi55: calls 356
MMdubaralho: folds 
*** TURN *** [Ah 9c 5h] [Ks]
EnSi55: checks 
banane4711 has returned
Caio Mugarte: bets 600
EnSi55: raises 1123 to 1723 and is all-in
Caio Mugarte: calls 1123
*** RIVER *** [Ah 9c 5h Ks] [Jc]
*** SHOW DOWN ***
EnSi55: shows [7d Ad] (a pair of Aces)
Caio Mugarte: shows [As Qd] (a pair of Aces - King+Queen kicker)
Caio Mugarte collected 5238 from pot
EnSi55 finished the tournament in 17th place
*** SUMMARY ***
Total pot 5238 | Rake 0 
Board [Ah 9c 5h Ks Jc]
Seat 2: banane4711 folded before Flop (didn't bet)
Seat 3: Tallir folded before Flop (didn't bet)
Seat 4: didyk59 (button) folded before Flop (didn't bet)
Seat 5: EnSi55 (small blind) showed [7d Ad] and lost with a pair of Aces
Seat 6: MMdubaralho (big blind) folded on the Flop
Seat 7: Caio Mugarte showed [As Qd] and won (5238) with a pair of Aces
Seat 8: Rosa885 folded on the Flop
Seat 9: Kuanyin156 folded before Flop (didn't bet)



PokerStars Hand #245425477886: Tournament #3632163743, $0.23+$0.02 USD Hold'em No Limit - Level V (60/120) - 2023/08/16 15:02:08 AT [2023/08/16 14:02:08 ET]
Table '3632163743 5' 9-max Seat #6 is the button
Seat 2: banane4711 (6221 in chips) 
Seat 3: Tallir (2698 in chips) 
Seat 4: didyk59 (1760 in chips) 
Seat 6: MMdubaralho (3406 in chips) 
Seat 7: Caio Mugarte (5421 in chips) 
Seat 8: Rosa885 (4396 in chips) 
Seat 9: Kuanyin156 (2488 in chips) 
banane4711: posts the ante 15
Tallir: posts the ante 15
didyk59: posts the ante 15
MMdubaralho: posts the ante 15
Caio Mugarte: posts the ante 15
Rosa885: posts the ante 15
Kuanyin156: posts the ante 15
Caio Mugarte: posts small blind 60
Rosa885: posts big blind 120
*** HOLE CARDS ***
Dealt to Caio Mugarte [5h 9s]
Kuanyin156: folds 
banane4711: folds 
Tallir: calls 120
didyk59: folds 
MMdubaralho: calls 120
Caio Mugarte: folds 
Rosa885: checks 
*** FLOP *** [As 8s 7h]
Rosa885: checks 
KaioPedro is disconnected 
Tallir: checks 
MMdubaralho: checks 
*** TURN *** [As 8s 7h] [9h]
Rosa885: checks 
Tallir: checks 
MMdubaralho: bets 263
Rosa885: folds 
Tallir: calls 263
*** RIVER *** [As 8s 7h 9h] [8h]
Tallir: checks 
MMdubaralho: bets 526
Tallir: folds 
Uncalled bet (526) returned to MMdubaralho
MMdubaralho collected 1051 from pot
MMdubaralho: doesn't show hand 
*** SUMMARY ***
Total pot 1051 | Rake 0 
Board [As 8s 7h 9h 8h]
Seat 2: banane4711 folded before Flop (didn't bet)
Seat 3: Tallir folded on the River
Seat 4: didyk59 folded before Flop (didn't bet)
Seat 6: MMdubaralho (button) collected (1051)
Seat 7: Caio Mugarte (small blind) folded before Flop
Seat 8: Rosa885 (big blind) folded on the Turn
Seat 9: Kuanyin156 folded before Flop (didn't bet)



PokerStars Hand #245425496064: Tournament #3632163743, $0.23+$0.02 USD Hold'em No Limit - Level V (60/120) - 2023/08/16 15:03:12 AT [2023/08/16 14:03:12 ET]
Table '3632163743 5' 9-max Seat #7 is the button
Seat 2: banane4711 (6206 in chips) 
Seat 3: Tallir (2300 in chips) 
Seat 4: didyk59 (1745 in chips) 
Seat 5: KaioPedro (2672 in chips) 
Seat 6: MMdubaralho (4059 in chips) 
Seat 7: Caio Mugarte (5346 in chips) 
Seat 8: Rosa885 (4261 in chips) 
Seat 9: Kuanyin156 (2473 in chips) 
banane4711: posts the ante 15
Tallir: posts the ante 15
didyk59: posts the ante 15
KaioPedro: posts the ante 15
MMdubaralho: posts the ante 15
Caio Mugarte: posts the ante 15
Rosa885: posts the ante 15
Kuanyin156: posts the ante 15
Rosa885: posts small blind 60
Kuanyin156: posts big blind 120
*** HOLE CARDS ***
Dealt to Caio Mugarte [4c 4d]
banane4711 has timed out
banane4711: folds 
banane4711 is sitting out
banane4711 has returned
Tallir: calls 120
didyk59: folds 
KaioPedro: folds 
MMdubaralho: calls 120
Caio Mugarte: calls 120
Rosa885: folds 
Kuanyin156: checks 
*** FLOP *** [Ac 6d 3c]
Kuanyin156: checks 
Tallir: checks 
MMdubaralho: checks 
Caio Mugarte: checks 
*** TURN *** [Ac 6d 3c] [8c]
Kuanyin156: checks 
Tallir: checks 
MMdubaralho: checks 
Caio Mugarte: checks 
*** RIVER *** [Ac 6d 3c 8c] [Td]
Kuanyin156: checks 
Tallir: checks 
MMdubaralho: checks 
Caio Mugarte: checks 
*** SHOW DOWN ***
Kuanyin156: shows [Qd Jh] (high card Ace)
Tallir: shows [Kc Th] (a pair of Tens)
MMdubaralho: mucks hand 
Caio Mugarte: mucks hand 
Tallir collected 660 from pot
*** SUMMARY ***
Total pot 660 | Rake 0 
Board [Ac 6d 3c 8c Td]
Seat 2: banane4711 folded before Flop (didn't bet)
Seat 3: Tallir showed [Kc Th] and won (660) with a pair of Tens
Seat 4: didyk59 folded before Flop (didn't bet)
Seat 5: KaioPedro folded before Flop (didn't bet)
Seat 6: MMdubaralho mucked [Jd 9c]
Seat 7: Caio Mugarte (button) mucked [4c 4d]
Seat 8: Rosa885 (small blind) folded before Flop
Seat 9: Kuanyin156 (big blind) showed [Qd Jh] and lost with high card Ace



PokerStars Hand #245425523470: Tournament #3632163743, $0.23+$0.02 USD Hold'em No Limit - Level VI (80/160) - 2023/08/16 15:04:46 AT [2023/08/16 14:04:46 ET]
Table '3632163743 5' 9-max Seat #8 is the button
Seat 2: banane4711 (6191 in chips) 
Seat 3: Tallir (2825 in chips) 
Seat 4: didyk59 (1730 in chips) 
Seat 5: KaioPedro (2657 in chips) 
Seat 6: MMdubaralho (3924 in chips) 
Seat 7: Caio Mugarte (5211 in chips) 
Seat 8: Rosa885 (4186 in chips) 
Seat 9: Kuanyin156 (2338 in chips) 
banane4711: posts the ante 20
Tallir: posts the ante 20
didyk59: posts the ante 20
KaioPedro: posts the ante 20
MMdubaralho: posts the ante 20
Caio Mugarte: posts the ante 20
Rosa885: posts the ante 20
Kuanyin156: posts the ante 20
Kuanyin156: posts small blind 80
banane4711: posts big blind 160
*** HOLE CARDS ***
Dealt to Caio Mugarte [8d 5c]
Tallir: calls 160
didyk59: folds 
KaioPedro: folds 
MMdubaralho: folds 
Caio Mugarte: folds 
Rosa885: folds 
Kuanyin156: calls 80
banane4711: raises 6011 to 6171 and is all-in
Tallir: folds 
Kuanyin156: folds 
Uncalled bet (6011) returned to banane4711
banane4711 collected 640 from pot
banane4711: doesn't show hand 
*** SUMMARY ***
Total pot 640 | Rake 0 
Seat 2: banane4711 (big blind) collected (640)
Seat 3: Tallir folded before Flop
Seat 4: didyk59 folded before Flop (didn't bet)
Seat 5: KaioPedro folded before Flop (didn't bet)
Seat 6: MMdubaralho folded before Flop (didn't bet)
Seat 7: Caio Mugarte folded before Flop (didn't bet)
Seat 8: Rosa885 (button) folded before Flop (didn't bet)
Seat 9: Kuanyin156 (small blind) folded before Flop



PokerStars Hand #245425533886: Tournament #3632163743, $0.23+$0.02 USD Hold'em No Limit - Level VI (80/160) - 2023/08/16 15:05:21 AT [2023/08/16 14:05:21 ET]
Table '3632163743 5' 9-max Seat #9 is the button
Seat 2: banane4711 (6651 in chips) 
Seat 3: Tallir (2645 in chips) 
Seat 4: didyk59 (1710 in chips) 
Seat 5: KaioPedro (2637 in chips) 
Seat 6: MMdubaralho (3904 in chips) 
Seat 7: Caio Mugarte (5191 in chips) 
Seat 8: Rosa885 (4166 in chips) 
Seat 9: Kuanyin156 (2158 in chips) 
banane4711: posts the ante 20
Tallir: posts the ante 20
didyk59: posts the ante 20
KaioPedro: posts the ante 20
MMdubaralho: posts the ante 20
Caio Mugarte: posts the ante 20
Rosa885: posts the ante 20
Kuanyin156: posts the ante 20
banane4711: posts small blind 80
Tallir: posts big blind 160
*** HOLE CARDS ***
Dealt to Caio Mugarte [4c 9h]
didyk59: folds 
KaioPedro: calls 160
MMdubaralho: folds 
Caio Mugarte: folds 
Rosa885: folds 
Kuanyin156: raises 1978 to 2138 and is all-in
banane4711: raises 1978 to 4116
Tallir: folds 
KaioPedro: folds 
Uncalled bet (1978) returned to banane4711
*** FLOP *** [Jc 6d Td]
*** TURN *** [Jc 6d Td] [Kh]
*** RIVER *** [Jc 6d Td Kh] [8d]
*** SHOW DOWN ***
banane4711: shows [Qs Qc] (a pair of Queens)
Kuanyin156: shows [As 5c] (high card Ace)
banane4711 collected 4756 from pot
Kuanyin156 finished the tournament in 15th place
*** SUMMARY ***
Total pot 4756 | Rake 0 
Board [Jc 6d Td Kh 8d]
Seat 2: banane4711 (small blind) showed [Qs Qc] and won (4756) with a pair of Queens
Seat 3: Tallir (big blind) folded before Flop
Seat 4: didyk59 folded before Flop (didn't bet)
Seat 5: KaioPedro folded before Flop
Seat 6: MMdubaralho folded before Flop (didn't bet)
Seat 7: Caio Mugarte folded before Flop (didn't bet)
Seat 8: Rosa885 folded before Flop (didn't bet)
Seat 9: Kuanyin156 (button) showed [As 5c] and lost with high card Ace



PokerStars Hand #245425548335: Tournament #3632163743, $0.23+$0.02 USD Hold'em No Limit - Level VI (80/160) - 2023/08/16 15:06:11 AT [2023/08/16 14:06:11 ET]
Table '3632163743 5' 9-max Seat #2 is the button
Seat 2: banane4711 (9249 in chips) 
Seat 3: Tallir (2465 in chips) 
Seat 4: didyk59 (1690 in chips) 
Seat 5: KaioPedro (2457 in chips) 
Seat 6: MMdubaralho (3884 in chips) 
Seat 7: Caio Mugarte (5171 in chips) 
Seat 8: Rosa885 (4146 in chips) 
banane4711: posts the ante 20
Tallir: posts the ante 20
didyk59: posts the ante 20
KaioPedro: posts the ante 20
MMdubaralho: posts the ante 20
Caio Mugarte: posts the ante 20
Rosa885: posts the ante 20
Tallir: posts small blind 80
didyk59: posts big blind 160
*** HOLE CARDS ***
Dealt to Caio Mugarte [3s 2h]
KaioPedro: folds 
MMdubaralho: folds 
Caio Mugarte: folds 
Rosa885: folds 
banane4711: folds 
Tallir: folds 
Uncalled bet (80) returned to didyk59
didyk59 collected 300 from pot
didyk59: doesn't show hand 
*** SUMMARY ***
Total pot 300 | Rake 0 
Seat 2: banane4711 (button) folded before Flop (didn't bet)
Seat 3: Tallir (small blind) folded before Flop
Seat 4: didyk59 (big blind) collected (300)
Seat 5: KaioPedro folded before Flop (didn't bet)
Seat 6: MMdubaralho folded before Flop (didn't bet)
Seat 7: Caio Mugarte folded before Flop (didn't bet)
Seat 8: Rosa885 folded before Flop (didn't bet)



PokerStars Hand #245425558417: Tournament #3632163743, $0.23+$0.02 USD Hold'em No Limit - Level VI (80/160) - 2023/08/16 15:06:45 AT [2023/08/16 14:06:45 ET]
Table '3632163743 5' 9-max Seat #3 is the button
Seat 2: banane4711 (9229 in chips) 
Seat 3: Tallir (2365 in chips) 
Seat 4: didyk59 (1890 in chips) 
Seat 5: KaioPedro (2437 in chips) 
Seat 6: MMdubaralho (3864 in chips) 
Seat 7: Caio Mugarte (5151 in chips) 
Seat 8: Rosa885 (4126 in chips) 
banane4711: posts the ante 20
Tallir: posts the ante 20
didyk59: posts the ante 20
KaioPedro: posts the ante 20
MMdubaralho: posts the ante 20
Caio Mugarte: posts the ante 20
Rosa885: posts the ante 20
didyk59: posts small blind 80
KaioPedro: posts big blind 160
*** HOLE CARDS ***
Dealt to Caio Mugarte [7c Jc]
MMdubaralho: folds 
Caio Mugarte: folds 
Rosa885: folds 
banane4711: folds 
Tallir: calls 160
didyk59: calls 80
KaioPedro: raises 2257 to 2417 and is all-in
Tallir: folds 
didyk59: folds 
Uncalled bet (2257) returned to KaioPedro
KaioPedro collected 620 from pot
KaioPedro: doesn't show hand 
*** SUMMARY ***
Total pot 620 | Rake 0 
Seat 2: banane4711 folded before Flop (didn't bet)
Seat 3: Tallir (button) folded before Flop
Seat 4: didyk59 (small blind) folded before Flop
Seat 5: KaioPedro (big blind) collected (620)
Seat 6: MMdubaralho folded before Flop (didn't bet)
Seat 7: Caio Mugarte folded before Flop (didn't bet)
Seat 8: Rosa885 folded before Flop (didn't bet)



PokerStars Hand #245425570715: Tournament #3632163743, $0.23+$0.02 USD Hold'em No Limit - Level VI (80/160) - 2023/08/16 15:07:27 AT [2023/08/16 14:07:27 ET]
Table '3632163743 5' 9-max Seat #4 is the button
Seat 2: banane4711 (9209 in chips) 
Seat 3: Tallir (2185 in chips) 
Seat 4: didyk59 (1710 in chips) 
Seat 5: KaioPedro (2877 in chips) 
Seat 6: MMdubaralho (3844 in chips) 
Seat 7: Caio Mugarte (5131 in chips) 
Seat 8: Rosa885 (4106 in chips) 
banane4711: posts the ante 20
Tallir: posts the ante 20
didyk59: posts the ante 20
KaioPedro: posts the ante 20
MMdubaralho: posts the ante 20
Caio Mugarte: posts the ante 20
Rosa885: posts the ante 20
KaioPedro: posts small blind 80
MMdubaralho: posts big blind 160
*** HOLE CARDS ***
Dealt to Caio Mugarte [5s Qh]
Caio Mugarte: folds 
Rosa885: folds 
banane4711: folds 
Tallir: folds 
didyk59: raises 1530 to 1690 and is all-in
KaioPedro: folds 
MMdubaralho: folds 
Uncalled bet (1530) returned to didyk59
didyk59 collected 540 from pot
didyk59: doesn't show hand 
*** SUMMARY ***
Total pot 540 | Rake 0 
Seat 2: banane4711 folded before Flop (didn't bet)
Seat 3: Tallir folded before Flop (didn't bet)
Seat 4: didyk59 (button) collected (540)
Seat 5: KaioPedro (small blind) folded before Flop
Seat 6: MMdubaralho (big blind) folded before Flop
Seat 7: Caio Mugarte folded before Flop (didn't bet)
Seat 8: Rosa885 folded before Flop (didn't bet)



PokerStars Hand #245425581285: Tournament #3632163743, $0.23+$0.02 USD Hold'em No Limit - Level VI (80/160) - 2023/08/16 15:08:03 AT [2023/08/16 14:08:03 ET]
Table '3632163743 5' 9-max Seat #5 is the button
Seat 2: banane4711 (9189 in chips) 
Seat 3: Tallir (2165 in chips) 
Seat 4: didyk59 (2070 in chips) 
Seat 5: KaioPedro (2777 in chips) 
Seat 6: MMdubaralho (3664 in chips) 
Seat 7: Caio Mugarte (5111 in chips) 
Seat 8: Rosa885 (4086 in chips) 
banane4711: posts the ante 20
Tallir: posts the ante 20
didyk59: posts the ante 20
KaioPedro: posts the ante 20
MMdubaralho: posts the ante 20
Caio Mugarte: posts the ante 20
Rosa885: posts the ante 20
MMdubaralho: posts small blind 80
Caio Mugarte: posts big blind 160
*** HOLE CARDS ***
Dealt to Caio Mugarte [Qs Ts]
Rosa885: folds 
banane4711: folds 
Tallir: folds 
didyk59: folds 
KaioPedro: folds 
MMdubaralho: calls 80
Caio Mugarte: checks 
*** FLOP *** [Ks 6h 8s]
MMdubaralho: bets 460
Caio Mugarte: calls 460
*** TURN *** [Ks 6h 8s] [Td]
MMdubaralho: bets 3024 and is all-in
Caio Mugarte: folds 
Uncalled bet (3024) returned to MMdubaralho
MMdubaralho collected 1380 from pot
MMdubaralho: doesn't show hand 
*** SUMMARY ***
Total pot 1380 | Rake 0 
Board [Ks 6h 8s Td]
Seat 2: banane4711 folded before Flop (didn't bet)
Seat 3: Tallir folded before Flop (didn't bet)
Seat 4: didyk59 folded before Flop (didn't bet)
Seat 5: KaioPedro (button) folded before Flop (didn't bet)
Seat 6: MMdubaralho (small blind) collected (1380)
Seat 7: Caio Mugarte (big blind) folded on the Turn
Seat 8: Rosa885 folded before Flop (didn't bet)



PokerStars Hand #245425603710: Tournament #3632163743, $0.23+$0.02 USD Hold'em No Limit - Level VI (80/160) - 2023/08/16 15:09:20 AT [2023/08/16 14:09:20 ET]
Table '3632163743 5' 9-max Seat #6 is the button
Seat 2: banane4711 (9169 in chips) 
Seat 3: Tallir (2145 in chips) 
Seat 4: didyk59 (2050 in chips) 
Seat 5: KaioPedro (2757 in chips) 
Seat 6: MMdubaralho (4404 in chips) 
Seat 7: Caio Mugarte (4471 in chips) 
Seat 8: Rosa885 (4066 in chips) 
banane4711: posts the ante 20
Tallir: posts the ante 20
didyk59: posts the ante 20
KaioPedro: posts the ante 20
MMdubaralho: posts the ante 20
Caio Mugarte: posts the ante 20
Rosa885: posts the ante 20
Caio Mugarte: posts small blind 80
Rosa885: posts big blind 160
*** HOLE CARDS ***
Dealt to Caio Mugarte [8c 9s]
banane4711: calls 160
Tallir: folds 
didyk59: folds 
KaioPedro: folds 
MMdubaralho: calls 160
Caio Mugarte: folds 
Rosa885: checks 
*** FLOP *** [Qh 3c 2c]
Rosa885: checks 
banane4711: checks 
MMdubaralho: checks 
*** TURN *** [Qh 3c 2c] [Js]
Rosa885: checks 
banane4711: checks 
MMdubaralho: checks 
*** RIVER *** [Qh 3c 2c Js] [4s]
Rosa885: checks 
banane4711: checks 
MMdubaralho: checks 
*** SHOW DOWN ***
Rosa885: shows [Kc 8d] (high card King)
banane4711: shows [Th Kd] (high card King - Queen+Jack+Ten kicker)
MMdubaralho: shows [Ad 9h] (high card Ace)
MMdubaralho collected 700 from pot
*** SUMMARY ***
Total pot 700 | Rake 0 
Board [Qh 3c 2c Js 4s]
Seat 2: banane4711 showed [Th Kd] and lost with high card King
Seat 3: Tallir folded before Flop (didn't bet)
Seat 4: didyk59 folded before Flop (didn't bet)
Seat 5: KaioPedro folded before Flop (didn't bet)
Seat 6: MMdubaralho (button) showed [Ad 9h] and won (700) with high card Ace
Seat 7: Caio Mugarte (small blind) folded before Flop
Seat 8: Rosa885 (big blind) showed [Kc 8d] and lost with high card King



PokerStars Hand #245425629028: Tournament #3632163743, $0.23+$0.02 USD Hold'em No Limit - Level VI (80/160) - 2023/08/16 15:10:47 AT [2023/08/16 14:10:47 ET]
Table '3632163743 5' 9-max Seat #7 is the button
Seat 2: banane4711 (8989 in chips) 
Seat 3: Tallir (2125 in chips) 
Seat 4: didyk59 (2030 in chips) 
Seat 5: KaioPedro (2737 in chips) 
Seat 6: MMdubaralho (4924 in chips) 
Seat 7: Caio Mugarte (4371 in chips) 
Seat 8: Rosa885 (3886 in chips) 
banane4711: posts the ante 20
Tallir: posts the ante 20
didyk59: posts the ante 20
KaioPedro: posts the ante 20
MMdubaralho: posts the ante 20
Caio Mugarte: posts the ante 20
Rosa885: posts the ante 20
Rosa885: posts small blind 80
banane4711: posts big blind 160
*** HOLE CARDS ***
Dealt to Caio Mugarte [4h As]
Tallir: folds 
didyk59: calls 160
KaioPedro: folds 
MMdubaralho: calls 160
Caio Mugarte: folds 
Rosa885: folds 
banane4711: checks 
*** FLOP *** [8c Qh 8d]
banane4711: checks 
didyk59: bets 320
MMdubaralho: folds 
banane4711: folds 
Uncalled bet (320) returned to didyk59
didyk59 collected 700 from pot
didyk59: doesn't show hand 
*** SUMMARY ***
Total pot 700 | Rake 0 
Board [8c Qh 8d]
Seat 2: banane4711 (big blind) folded on the Flop
Seat 3: Tallir folded before Flop (didn't bet)
Seat 4: didyk59 collected (700)
Seat 5: KaioPedro folded before Flop (didn't bet)
Seat 6: MMdubaralho folded on the Flop
Seat 7: Caio Mugarte (button) folded before Flop (didn't bet)
Seat 8: Rosa885 (small blind) folded before Flop



PokerStars Hand #245425645538: Tournament #3632163743, $0.23+$0.02 USD Hold'em No Limit - Level VI (80/160) - 2023/08/16 15:11:43 AT [2023/08/16 14:11:43 ET]
Table '3632163743 5' 9-max Seat #8 is the button
Seat 2: banane4711 (8809 in chips) 
Seat 3: Tallir (2105 in chips) 
Seat 4: didyk59 (2550 in chips) 
Seat 5: KaioPedro (2717 in chips) 
Seat 6: MMdubaralho (4744 in chips) 
Seat 7: Caio Mugarte (4351 in chips) 
Seat 8: Rosa885 (3786 in chips) 
banane4711: posts the ante 20
Tallir: posts the ante 20
didyk59: posts the ante 20
KaioPedro: posts the ante 20
MMdubaralho: posts the ante 20
Caio Mugarte: posts the ante 20
Rosa885: posts the ante 20
banane4711: posts small blind 80
Tallir: posts big blind 160
*** HOLE CARDS ***
Dealt to Caio Mugarte [5s 4d]
didyk59: folds 
KaioPedro has timed out
KaioPedro: folds 
KaioPedro is sitting out
MMdubaralho: folds 
Caio Mugarte: folds 
Rosa885: folds 
banane4711: calls 80
Tallir: checks 
*** FLOP *** [8s Jc Td]
KaioPedro has returned
banane4711: bets 345
Tallir: folds 
Uncalled bet (345) returned to banane4711
banane4711 collected 460 from pot
banane4711: doesn't show hand 
*** SUMMARY ***
Total pot 460 | Rake 0 
Board [8s Jc Td]
Seat 2: banane4711 (small blind) collected (460)
Seat 3: Tallir (big blind) folded on the Flop
Seat 4: didyk59 folded before Flop (didn't bet)
Seat 5: KaioPedro folded before Flop (didn't bet)
Seat 6: MMdubaralho folded before Flop (didn't bet)
Seat 7: Caio Mugarte folded before Flop (didn't bet)
Seat 8: Rosa885 (button) folded before Flop (didn't bet)



PokerStars Hand #245425658419: Tournament #3632163743, $0.23+$0.02 USD Hold'em No Limit - Level VI (80/160) - 2023/08/16 15:12:27 AT [2023/08/16 14:12:27 ET]
Table '3632163743 5' 9-max Seat #2 is the button
Seat 2: banane4711 (9089 in chips) 
Seat 3: Tallir (1925 in chips) 
Seat 4: didyk59 (2530 in chips) 
Seat 5: KaioPedro (2697 in chips) 
Seat 6: MMdubaralho (4724 in chips) 
Seat 7: Caio Mugarte (4331 in chips) 
Seat 8: Rosa885 (3766 in chips) 
banane4711: posts the ante 20
Tallir: posts the ante 20
didyk59: posts the ante 20
KaioPedro: posts the ante 20
MMdubaralho: posts the ante 20
Caio Mugarte: posts the ante 20
Rosa885: posts the ante 20
Tallir: posts small blind 80
didyk59: posts big blind 160
*** HOLE CARDS ***
Dealt to Caio Mugarte [Kd 9c]
KaioPedro: folds 
MMdubaralho: folds 
Caio Mugarte: folds 
Rosa885: folds 
banane4711: folds 
Tallir: folds 
Uncalled bet (80) returned to didyk59
didyk59 collected 300 from pot
didyk59: doesn't show hand 
*** SUMMARY ***
Total pot 300 | Rake 0 
Seat 2: banane4711 (button) folded before Flop (didn't bet)
Seat 3: Tallir (small blind) folded before Flop
Seat 4: didyk59 (big blind) collected (300)
Seat 5: KaioPedro folded before Flop (didn't bet)
Seat 6: MMdubaralho folded before Flop (didn't bet)
Seat 7: Caio Mugarte folded before Flop (didn't bet)
Seat 8: Rosa885 folded before Flop (didn't bet)



PokerStars Hand #245425667714: Tournament #3632163743, $0.23+$0.02 USD Hold'em No Limit - Level VI (80/160) - 2023/08/16 15:12:58 AT [2023/08/16 14:12:58 ET]
Table '3632163743 5' 9-max Seat #3 is the button
Seat 2: banane4711 (9069 in chips) 
Seat 3: Tallir (1825 in chips) 
Seat 4: didyk59 (2730 in chips) 
Seat 5: KaioPedro (2677 in chips) 
Seat 6: MMdubaralho (4704 in chips) 
Seat 7: Caio Mugarte (4311 in chips) 
Seat 8: Rosa885 (3746 in chips) 
banane4711: posts the ante 20
Tallir: posts the ante 20
didyk59: posts the ante 20
KaioPedro: posts the ante 20
MMdubaralho: posts the ante 20
Caio Mugarte: posts the ante 20
Rosa885: posts the ante 20
didyk59: posts small blind 80
KaioPedro: posts big blind 160
*** HOLE CARDS ***
Dealt to Caio Mugarte [8c 9s]
MMdubaralho: folds 
Caio Mugarte: folds 
Rosa885: folds 
banane4711: folds 
Tallir: calls 160
didyk59: folds 
KaioPedro: checks 
*** FLOP *** [Ac Jd 6c]
KaioPedro: checks 
Tallir: bets 160
KaioPedro: calls 160
*** TURN *** [Ac Jd 6c] [6d]
KaioPedro: checks 
Tallir: checks 
*** RIVER *** [Ac Jd 6c 6d] [2d]
KaioPedro: checks 
Tallir: checks 
*** SHOW DOWN ***
KaioPedro: shows [Kc 3c] (a pair of Sixes)
Tallir: shows [Ah 4s] (two pair, Aces and Sixes)
Tallir collected 860 from pot
*** SUMMARY ***
Total pot 860 | Rake 0 
Board [Ac Jd 6c 6d 2d]
Seat 2: banane4711 folded before Flop (didn't bet)
Seat 3: Tallir (button) showed [Ah 4s] and won (860) with two pair, Aces and Sixes
Seat 4: didyk59 (small blind) folded before Flop
Seat 5: KaioPedro (big blind) showed [Kc 3c] and lost with a pair of Sixes
Seat 6: MMdubaralho folded before Flop (didn't bet)
Seat 7: Caio Mugarte folded before Flop (didn't bet)
Seat 8: Rosa885 folded before Flop (didn't bet)



PokerStars Hand #245425680604: Tournament #3632163743, $0.23+$0.02 USD Hold'em No Limit - Level VI (80/160) - 2023/08/16 15:13:42 AT [2023/08/16 14:13:42 ET]
Table '3632163743 5' 9-max Seat #4 is the button
Seat 2: banane4711 (9049 in chips) 
Seat 3: Tallir (2345 in chips) 
Seat 4: didyk59 (2630 in chips) 
Seat 5: KaioPedro (2337 in chips) 
Seat 6: MMdubaralho (4684 in chips) 
Seat 7: Caio Mugarte (4291 in chips) 
Seat 8: Rosa885 (3726 in chips) 
banane4711: posts the ante 20
Tallir: posts the ante 20
didyk59: posts the ante 20
KaioPedro: posts the ante 20
MMdubaralho: posts the ante 20
Caio Mugarte: posts the ante 20
Rosa885: posts the ante 20
KaioPedro: posts small blind 80
MMdubaralho: posts big blind 160
*** HOLE CARDS ***
Dealt to Caio Mugarte [4d 5d]
Caio Mugarte: folds 
Rosa885: folds 
banane4711: folds 
Tallir: folds 
didyk59: folds 
KaioPedro: folds 
Uncalled bet (80) returned to MMdubaralho
MMdubaralho collected 300 from pot
MMdubaralho: doesn't show hand 
*** SUMMARY ***
Total pot 300 | Rake 0 
Seat 2: banane4711 folded before Flop (didn't bet)
Seat 3: Tallir folded before Flop (didn't bet)
Seat 4: didyk59 (button) folded before Flop (didn't bet)
Seat 5: KaioPedro (small blind) folded before Flop
Seat 6: MMdubaralho (big blind) collected (300)
Seat 7: Caio Mugarte folded before Flop (didn't bet)
Seat 8: Rosa885 folded before Flop (didn't bet)



PokerStars Hand #245425692418: Tournament #3632163743, $0.23+$0.02 USD Hold'em No Limit - Level VII (100/200) - 2023/08/16 15:14:22 AT [2023/08/16 14:14:22 ET]
Table '3632163743 5' 9-max Seat #5 is the button
Seat 2: banane4711 (9029 in chips) 
Seat 3: Tallir (2325 in chips) 
Seat 4: didyk59 (2610 in chips) 
Seat 5: KaioPedro (2237 in chips) 
Seat 6: MMdubaralho (4884 in chips) 
Seat 7: Caio Mugarte (4271 in chips) 
Seat 8: Rosa885 (3706 in chips) 
banane4711: posts the ante 25
Tallir: posts the ante 25
didyk59: posts the ante 25
KaioPedro: posts the ante 25
MMdubaralho: posts the ante 25
Caio Mugarte: posts the ante 25
Rosa885: posts the ante 25
MMdubaralho: posts small blind 100
Caio Mugarte: posts big blind 200
*** HOLE CARDS ***
Dealt to Caio Mugarte [Ts 9h]
Rosa885: folds 
banane4711: folds 
Tallir: folds 
didyk59: folds 
KaioPedro: folds 
MMdubaralho: folds 
Uncalled bet (100) returned to Caio Mugarte
Caio Mugarte collected 375 from pot
Caio Mugarte: doesn't show hand 
*** SUMMARY ***
Total pot 375 | Rake 0 
Seat 2: banane4711 folded before Flop (didn't bet)
Seat 3: Tallir folded before Flop (didn't bet)
Seat 4: didyk59 folded before Flop (didn't bet)
Seat 5: KaioPedro (button) folded before Flop (didn't bet)
Seat 6: MMdubaralho (small blind) folded before Flop
Seat 7: Caio Mugarte (big blind) collected (375)
Seat 8: Rosa885 folded before Flop (didn't bet)



PokerStars Hand #245425698990: Tournament #3632163743, $0.23+$0.02 USD Hold'em No Limit - Level VII (100/200) - 2023/08/16 15:14:45 AT [2023/08/16 14:14:45 ET]
Table '3632163743 5' 9-max Seat #6 is the button
Seat 2: banane4711 (9004 in chips) 
Seat 3: Tallir (2300 in chips) 
Seat 4: didyk59 (2585 in chips) 
Seat 5: KaioPedro (2212 in chips) 
Seat 6: MMdubaralho (4759 in chips) 
Seat 7: Caio Mugarte (4521 in chips) 
Seat 8: Rosa885 (3681 in chips) 
banane4711: posts the ante 25
Tallir: posts the ante 25
didyk59: posts the ante 25
KaioPedro: posts the ante 25
MMdubaralho: posts the ante 25
Caio Mugarte: posts the ante 25
Rosa885: posts the ante 25
Caio Mugarte: posts small blind 100
Rosa885: posts big blind 200
*** HOLE CARDS ***
Dealt to Caio Mugarte [Qc 7h]
banane4711: folds 
Tallir: calls 200
didyk59: folds 
KaioPedro: folds 
MMdubaralho: folds 
Caio Mugarte: folds 
Rosa885: checks 
*** FLOP *** [Jh 6s 9d]
Rosa885: checks 
Tallir: bets 200
Rosa885: folds 
Uncalled bet (200) returned to Tallir
Tallir collected 675 from pot
*** SUMMARY ***
Total pot 675 | Rake 0 
Board [Jh 6s 9d]
Seat 2: banane4711 folded before Flop (didn't bet)
Seat 3: Tallir collected (675)
Seat 4: didyk59 folded before Flop (didn't bet)
Seat 5: KaioPedro folded before Flop (didn't bet)
Seat 6: MMdubaralho (button) folded before Flop (didn't bet)
Seat 7: Caio Mugarte (small blind) folded before Flop
Seat 8: Rosa885 (big blind) folded on the Flop



PokerStars Hand #245425713783: Tournament #3632163743, $0.23+$0.02 USD Hold'em No Limit - Level VII (100/200) - 2023/08/16 15:15:34 AT [2023/08/16 14:15:34 ET]
Table '3632163743 5' 9-max Seat #7 is the button
Seat 2: banane4711 (8979 in chips) 
Seat 3: Tallir (2750 in chips) 
Seat 4: didyk59 (2560 in chips) 
Seat 5: KaioPedro (2187 in chips) 
Seat 6: MMdubaralho (4734 in chips) 
Seat 7: Caio Mugarte (4396 in chips) 
Seat 8: Rosa885 (3456 in chips) 
banane4711: posts the ante 25
Tallir: posts the ante 25
didyk59: posts the ante 25
KaioPedro: posts the ante 25
MMdubaralho: posts the ante 25
Caio Mugarte: posts the ante 25
Rosa885: posts the ante 25
Rosa885: posts small blind 100
banane4711: posts big blind 200
*** HOLE CARDS ***
Dealt to Caio Mugarte [6h Js]
Tallir: calls 200
didyk59: folds 
KaioPedro: folds 
MMdubaralho: folds 
Caio Mugarte: folds 
Rosa885: calls 100
banane4711 has timed out
banane4711: checks 
*** FLOP *** [9c Ad Qh]
Rosa885: checks 
banane4711: checks 
Tallir: bets 200
Rosa885: calls 200
banane4711: folds 
*** TURN *** [9c Ad Qh] [Td]
Rosa885: checks 
Tallir: bets 200
Rosa885: folds 
Uncalled bet (200) returned to Tallir
Tallir collected 1175 from pot
*** SUMMARY ***
Total pot 1175 | Rake 0 
Board [9c Ad Qh Td]
Seat 2: banane4711 (big blind) folded on the Flop
Seat 3: Tallir collected (1175)
Seat 4: didyk59 folded before Flop (didn't bet)
Seat 5: KaioPedro folded before Flop (didn't bet)
Seat 6: MMdubaralho folded before Flop (didn't bet)
Seat 7: Caio Mugarte (button) folded before Flop (didn't bet)
Seat 8: Rosa885 (small blind) folded on the Turn



PokerStars Hand #245425732527: Tournament #3632163743, $0.23+$0.02 USD Hold'em No Limit - Level VII (100/200) - 2023/08/16 15:16:38 AT [2023/08/16 14:16:38 ET]
Table '3632163743 5' 9-max Seat #8 is the button
Seat 2: banane4711 (8754 in chips) 
Seat 3: Tallir (3500 in chips) 
Seat 4: didyk59 (2535 in chips) 
Seat 5: KaioPedro (2162 in chips) 
Seat 6: MMdubaralho (4709 in chips) 
Seat 7: Caio Mugarte (4371 in chips) 
Seat 8: Rosa885 (3031 in chips) 
banane4711: posts the ante 25
Tallir: posts the ante 25
didyk59: posts the ante 25
KaioPedro: posts the ante 25
MMdubaralho: posts the ante 25
Caio Mugarte: posts the ante 25
Rosa885: posts the ante 25
banane4711: posts small blind 100
Tallir: posts big blind 200
*** HOLE CARDS ***
Dealt to Caio Mugarte [7d Jc]
didyk59: folds 
KaioPedro: folds 
MMdubaralho: folds 
Caio Mugarte: folds 
Rosa885: folds 
banane4711: folds 
Uncalled bet (100) returned to Tallir
Tallir collected 375 from pot
*** SUMMARY ***
Total pot 375 | Rake 0 
Seat 2: banane4711 (small blind) folded before Flop
Seat 3: Tallir (big blind) collected (375)
Seat 4: didyk59 folded before Flop (didn't bet)
Seat 5: KaioPedro folded before Flop (didn't bet)
Seat 6: MMdubaralho folded before Flop (didn't bet)
Seat 7: Caio Mugarte folded before Flop (didn't bet)
Seat 8: Rosa885 (button) folded before Flop (didn't bet)



PokerStars Hand #245425740123: Tournament #3632163743, $0.23+$0.02 USD Hold'em No Limit - Level VII (100/200) - 2023/08/16 15:17:03 AT [2023/08/16 14:17:03 ET]
Table '3632163743 5' 9-max Seat #2 is the button
Seat 2: banane4711 (8629 in chips) 
Seat 3: Tallir (3750 in chips) 
Seat 4: didyk59 (2510 in chips) 
Seat 5: KaioPedro (2137 in chips) 
Seat 6: MMdubaralho (4684 in chips) 
Seat 7: Caio Mugarte (4346 in chips) 
Seat 8: Rosa885 (3006 in chips) 
banane4711: posts the ante 25
Tallir: posts the ante 25
didyk59: posts the ante 25
KaioPedro: posts the ante 25
MMdubaralho: posts the ante 25
Caio Mugarte: posts the ante 25
Rosa885: posts the ante 25
Tallir: posts small blind 100
didyk59: posts big blind 200
*** HOLE CARDS ***
Dealt to Caio Mugarte [4s Ad]
KaioPedro: folds 
MMdubaralho: raises 200 to 400
Caio Mugarte: folds 
Rosa885: folds 
banane4711: folds 
Tallir: calls 300
didyk59: folds 
*** FLOP *** [9h Kd Qc]
Tallir: checks 
MMdubaralho: bets 4259 and is all-in
Tallir: folds 
Uncalled bet (4259) returned to MMdubaralho
MMdubaralho collected 1175 from pot
MMdubaralho: doesn't show hand 
*** SUMMARY ***
Total pot 1175 | Rake 0 
Board [9h Kd Qc]
Seat 2: banane4711 (button) folded before Flop (didn't bet)
Seat 3: Tallir (small blind) folded on the Flop
Seat 4: didyk59 (big blind) folded before Flop
Seat 5: KaioPedro folded before Flop (didn't bet)
Seat 6: MMdubaralho collected (1175)
Seat 7: Caio Mugarte folded before Flop (didn't bet)
Seat 8: Rosa885 folded before Flop (didn't bet)



PokerStars Hand #245425750480: Tournament #3632163743, $0.23+$0.02 USD Hold'em No Limit - Level VII (100/200) - 2023/08/16 15:17:37 AT [2023/08/16 14:17:37 ET]
Table '3632163743 5' 9-max Seat #3 is the button
Seat 2: banane4711 (8604 in chips) 
Seat 3: Tallir (3325 in chips) 
Seat 4: didyk59 (2285 in chips) 
Seat 5: KaioPedro (2112 in chips) 
Seat 6: MMdubaralho (5434 in chips) 
Seat 7: Caio Mugarte (4321 in chips) 
Seat 8: Rosa885 (2981 in chips) 
banane4711: posts the ante 25
Tallir: posts the ante 25
didyk59: posts the ante 25
KaioPedro: posts the ante 25
MMdubaralho: posts the ante 25
Caio Mugarte: posts the ante 25
Rosa885: posts the ante 25
didyk59: posts small blind 100
KaioPedro: posts big blind 200
*** HOLE CARDS ***
Dealt to Caio Mugarte [5s 3s]
MMdubaralho: folds 
Caio Mugarte: folds 
Rosa885: folds 
banane4711: folds 
Tallir: folds 
didyk59: folds 
Uncalled bet (100) returned to KaioPedro
KaioPedro collected 375 from pot
*** SUMMARY ***
Total pot 375 | Rake 0 
Seat 2: banane4711 folded before Flop (didn't bet)
Seat 3: Tallir (button) folded before Flop (didn't bet)
Seat 4: didyk59 (small blind) folded before Flop
Seat 5: KaioPedro (big blind) collected (375)
Seat 6: MMdubaralho folded before Flop (didn't bet)
Seat 7: Caio Mugarte folded before Flop (didn't bet)
Seat 8: Rosa885 folded before Flop (didn't bet)



PokerStars Hand #245425758647: Tournament #3632163743, $0.23+$0.02 USD Hold'em No Limit - Level VII (100/200) - 2023/08/16 15:18:05 AT [2023/08/16 14:18:05 ET]
Table '3632163743 4' 9-max Seat #5 is the button
Seat 1: Caio Mugarte (4296 in chips) 
Seat 2: Rx_Kings (4931 in chips) 
Seat 4: dp2122 (9926 in chips) 
Seat 5: stalin191137 (5722 in chips) 
Seat 8: Asildar (10828 in chips) 
Seat 9: ari155863 (7031 in chips) 
Caio Mugarte: posts the ante 25
Rx_Kings: posts the ante 25
dp2122: posts the ante 25
stalin191137: posts the ante 25
Asildar: posts the ante 25
ari155863: posts the ante 25
Asildar: posts small blind 100
ari155863: posts big blind 200
*** HOLE CARDS ***
Dealt to Caio Mugarte [2c 7d]
Caio Mugarte: folds 
Rx_Kings: folds 
dp2122: calls 200
stalin191137: folds 
Asildar: calls 100
ari155863: checks 
*** FLOP *** [Jc Ac 7s]
Asildar: checks 
ari155863: checks 
dp2122: bets 200
Asildar: calls 200
ari155863: folds 
*** TURN *** [Jc Ac 7s] [Kd]
Asildar: checks 
dp2122: checks 
*** RIVER *** [Jc Ac 7s Kd] [5s]
Asildar: bets 874
dp2122: folds 
Uncalled bet (874) returned to Asildar
Asildar collected 1150 from pot
Asildar: doesn't show hand 
*** SUMMARY ***
Total pot 1150 | Rake 0 
Board [Jc Ac 7s Kd 5s]
Seat 1: Caio Mugarte folded before Flop (didn't bet)
Seat 2: Rx_Kings folded before Flop (didn't bet)
Seat 4: dp2122 folded on the River
Seat 5: stalin191137 (button) folded before Flop (didn't bet)
Seat 8: Asildar (small blind) collected (1150)
Seat 9: ari155863 (big blind) folded on the Flop



PokerStars Hand #245425767637: Tournament #3632163743, $0.23+$0.02 USD Hold'em No Limit - Level VII (100/200) - 2023/08/16 15:18:35 AT [2023/08/16 14:18:35 ET]
Table '3632163743 4' 9-max Seat #8 is the button
Seat 1: Caio Mugarte (4271 in chips) 
Seat 2: Rx_Kings (4906 in chips) 
Seat 4: dp2122 (9501 in chips) 
Seat 5: stalin191137 (5697 in chips) 
Seat 8: Asildar (11553 in chips) 
Seat 9: ari155863 (6806 in chips) 
Caio Mugarte: posts the ante 25
Rx_Kings: posts the ante 25
dp2122: posts the ante 25
stalin191137: posts the ante 25
Asildar: posts the ante 25
ari155863: posts the ante 25
ari155863: posts small blind 100
Caio Mugarte: posts big blind 200
*** HOLE CARDS ***
Dealt to Caio Mugarte [Jh 4h]
Rx_Kings: folds 
dp2122: folds 
stalin191137: folds 
Asildar: raises 200 to 400
ari155863: folds 
Caio Mugarte: calls 200
*** FLOP *** [5c Jc Jd]
Caio Mugarte: checks 
Asildar: checks 
*** TURN *** [5c Jc Jd] [5h]
Caio Mugarte: bets 347
Asildar: calls 347
*** RIVER *** [5c Jc Jd 5h] [5d]
Caio Mugarte: bets 3499 and is all-in
Asildar: folds 
Uncalled bet (3499) returned to Caio Mugarte
Caio Mugarte collected 1744 from pot
Caio Mugarte: doesn't show hand 
*** SUMMARY ***
Total pot 1744 | Rake 0 
Board [5c Jc Jd 5h 5d]
Seat 1: Caio Mugarte (big blind) collected (1744)
Seat 2: Rx_Kings folded before Flop (didn't bet)
Seat 4: dp2122 folded before Flop (didn't bet)
Seat 5: stalin191137 folded before Flop (didn't bet)
Seat 8: Asildar (button) folded on the River
Seat 9: ari155863 (small blind) folded before Flop



PokerStars Hand #245425780769: Tournament #3632163743, $0.23+$0.02 USD Hold'em No Limit - Level VII (100/200) - 2023/08/16 15:19:19 AT [2023/08/16 14:19:19 ET]
Table '3632163743 4' 9-max Seat #9 is the button
Seat 1: Caio Mugarte (5243 in chips) 
Seat 2: Rx_Kings (4881 in chips) 
Seat 4: dp2122 (9476 in chips) 
Seat 5: stalin191137 (5672 in chips) 
Seat 8: Asildar (10781 in chips) 
Seat 9: ari155863 (6681 in chips) 
Caio Mugarte: posts the ante 25
Rx_Kings: posts the ante 25
dp2122: posts the ante 25
stalin191137: posts the ante 25
Asildar: posts the ante 25
ari155863: posts the ante 25
Caio Mugarte: posts small blind 100
Rx_Kings: posts big blind 200
*** HOLE CARDS ***
Dealt to Caio Mugarte [5c 6c]
dp2122: folds 
stalin191137: folds 
Asildar: raises 200 to 400
ari155863: calls 400
Caio Mugarte: folds 
Rx_Kings: folds 
*** FLOP *** [9h Ah 3s]
Asildar: checks 
ari155863: checks 
*** TURN *** [9h Ah 3s] [Qs]
Asildar: bets 848
ari155863: calls 848
*** RIVER *** [9h Ah 3s Qs] [3h]
Asildar: bets 2439
ari155863: folds 
Uncalled bet (2439) returned to Asildar
Asildar collected 2946 from pot
Asildar: doesn't show hand 
*** SUMMARY ***
Total pot 2946 | Rake 0 
Board [9h Ah 3s Qs 3h]
Seat 1: Caio Mugarte (small blind) folded before Flop
Seat 2: Rx_Kings (big blind) folded before Flop
Seat 4: dp2122 folded before Flop (didn't bet)
Seat 5: stalin191137 folded before Flop (didn't bet)
Seat 8: Asildar collected (2946)
Seat 9: ari155863 (button) folded on the River



PokerStars Hand #245425792868: Tournament #3632163743, $0.23+$0.02 USD Hold'em No Limit - Level VII (100/200) - 2023/08/16 15:20:00 AT [2023/08/16 14:20:00 ET]
Table '3632163743 4' 9-max Seat #1 is the button
Seat 1: Caio Mugarte (5118 in chips) 
Seat 2: Rx_Kings (4656 in chips) 
Seat 4: dp2122 (9451 in chips) 
Seat 5: stalin191137 (5647 in chips) 
Seat 8: Asildar (12454 in chips) 
Seat 9: ari155863 (5408 in chips) 
Caio Mugarte: posts the ante 25
Rx_Kings: posts the ante 25
dp2122: posts the ante 25
stalin191137: posts the ante 25
Asildar: posts the ante 25
ari155863: posts the ante 25
Rx_Kings: posts small blind 100
dp2122: posts big blind 200
*** HOLE CARDS ***
Dealt to Caio Mugarte [Th Tc]
stalin191137: folds 
Asildar: raises 200 to 400
ari155863: folds 
Caio Mugarte: calls 400
Rx_Kings: folds 
dp2122: calls 200
*** FLOP *** [5c Qd Js]
dp2122: checks 
Asildar: checks 
Caio Mugarte: bets 400
dp2122: folds 
Asildar: folds 
Uncalled bet (400) returned to Caio Mugarte
Caio Mugarte collected 1450 from pot
Caio Mugarte: doesn't show hand 
*** SUMMARY ***
Total pot 1450 | Rake 0 
Board [5c Qd Js]
Seat 1: Caio Mugarte (button) collected (1450)
Seat 2: Rx_Kings (small blind) folded before Flop
Seat 4: dp2122 (big blind) folded on the Flop
Seat 5: stalin191137 folded before Flop (didn't bet)
Seat 8: Asildar folded on the Flop
Seat 9: ari155863 folded before Flop (didn't bet)



PokerStars Hand #245425803595: Tournament #3632163743, $0.23+$0.02 USD Hold'em No Limit - Level VII (100/200) - 2023/08/16 15:20:36 AT [2023/08/16 14:20:36 ET]
Table '3632163743 4' 9-max Seat #2 is the button
Seat 1: Caio Mugarte (6143 in chips) 
Seat 2: Rx_Kings (4531 in chips) 
Seat 4: dp2122 (9026 in chips) 
Seat 5: stalin191137 (5622 in chips) 
Seat 8: Asildar (12029 in chips) 
Seat 9: ari155863 (5383 in chips) 
Caio Mugarte: posts the ante 25
Rx_Kings: posts the ante 25
dp2122: posts the ante 25
stalin191137: posts the ante 25
Asildar: posts the ante 25
ari155863: posts the ante 25
dp2122: posts small blind 100
stalin191137: posts big blind 200
*** HOLE CARDS ***
Dealt to Caio Mugarte [2d Jc]
Asildar: raises 200 to 400
ari155863: folds 
Caio Mugarte: folds 
Rx_Kings: folds 
dp2122: calls 300
stalin191137: folds 
*** FLOP *** [Qc 9s 5s]
dp2122: checks 
Asildar: bets 391
dp2122: calls 391
*** TURN *** [Qc 9s 5s] [Js]
dp2122: checks 
Asildar: checks 
*** RIVER *** [Qc 9s 5s Js] [Jh]
dp2122: bets 200
Asildar: calls 200
*** SHOW DOWN ***
dp2122: shows [2c Ac] (a pair of Jacks)
Asildar: shows [Ah 8d] (a pair of Jacks)
dp2122 collected 1166 from pot
Asildar collected 1166 from pot
*** SUMMARY ***
Total pot 2332 | Rake 0 
Board [Qc 9s 5s Js Jh]
Seat 1: Caio Mugarte folded before Flop (didn't bet)
Seat 2: Rx_Kings (button) folded before Flop (didn't bet)
Seat 4: dp2122 (small blind) showed [2c Ac] and won (1166) with a pair of Jacks
Seat 5: stalin191137 (big blind) folded before Flop
Seat 8: Asildar showed [Ah 8d] and won (1166) with a pair of Jacks
Seat 9: ari155863 folded before Flop (didn't bet)



PokerStars Hand #245425813455: Tournament #3632163743, $0.23+$0.02 USD Hold'em No Limit - Level VII (100/200) - 2023/08/16 15:21:10 AT [2023/08/16 14:21:10 ET]
Table '3632163743 4' 9-max Seat #4 is the button
Seat 1: Caio Mugarte (6118 in chips) 
Seat 2: Rx_Kings (4506 in chips) 
Seat 4: dp2122 (9176 in chips) 
Seat 5: stalin191137 (5397 in chips) 
Seat 8: Asildar (12179 in chips) 
Seat 9: ari155863 (5358 in chips) 
Caio Mugarte: posts the ante 25
Rx_Kings: posts the ante 25
dp2122: posts the ante 25
stalin191137: posts the ante 25
Asildar: posts the ante 25
ari155863: posts the ante 25
stalin191137: posts small blind 100
Asildar: posts big blind 200
*** HOLE CARDS ***
Dealt to Caio Mugarte [6c Qs]
ari155863: folds 
Caio Mugarte: folds 
Rx_Kings: folds 
dp2122: folds 
stalin191137: calls 100
Asildar: raises 11954 to 12154 and is all-in
stalin191137: folds 
Uncalled bet (11954) returned to Asildar
Asildar collected 550 from pot
Asildar: doesn't show hand 
*** SUMMARY ***
Total pot 550 | Rake 0 
Seat 1: Caio Mugarte folded before Flop (didn't bet)
Seat 2: Rx_Kings folded before Flop (didn't bet)
Seat 4: dp2122 (button) folded before Flop (didn't bet)
Seat 5: stalin191137 (small blind) folded before Flop
Seat 8: Asildar (big blind) collected (550)
Seat 9: ari155863 folded before Flop (didn't bet)



PokerStars Hand #245425819170: Tournament #3632163743, $0.23+$0.02 USD Hold'em No Limit - Level VII (100/200) - 2023/08/16 15:21:29 AT [2023/08/16 14:21:29 ET]
Table '3632163743 4' 9-max Seat #5 is the button
Seat 1: Caio Mugarte (6093 in chips) 
Seat 2: Rx_Kings (4481 in chips) 
Seat 4: dp2122 (9151 in chips) 
Seat 5: stalin191137 (5172 in chips) 
Seat 8: Asildar (12504 in chips) 
Seat 9: ari155863 (5333 in chips) 
Caio Mugarte: posts the ante 25
Rx_Kings: posts the ante 25
dp2122: posts the ante 25
stalin191137: posts the ante 25
Asildar: posts the ante 25
ari155863: posts the ante 25
Asildar: posts small blind 100
ari155863: posts big blind 200
*** HOLE CARDS ***
Dealt to Caio Mugarte [2h Jh]
Caio Mugarte: folds 
Rx_Kings: folds 
dp2122: folds 
stalin191137: folds 
Asildar: folds 
Uncalled bet (100) returned to ari155863
ari155863 collected 350 from pot
ari155863: doesn't show hand 
*** SUMMARY ***
Total pot 350 | Rake 0 
Seat 1: Caio Mugarte folded before Flop (didn't bet)
Seat 2: Rx_Kings folded before Flop (didn't bet)
Seat 4: dp2122 folded before Flop (didn't bet)
Seat 5: stalin191137 (button) folded before Flop (didn't bet)
Seat 8: Asildar (small blind) folded before Flop
Seat 9: ari155863 (big blind) collected (350)



PokerStars Hand #245425824987: Tournament #3632163743, $0.23+$0.02 USD Hold'em No Limit - Level VII (100/200) - 2023/08/16 15:21:49 AT [2023/08/16 14:21:49 ET]
Table '3632163743 4' 9-max Seat #8 is the button
Seat 1: Caio Mugarte (6068 in chips) 
Seat 2: Rx_Kings (4456 in chips) 
Seat 4: dp2122 (9126 in chips) 
Seat 5: stalin191137 (5147 in chips) 
Seat 8: Asildar (12379 in chips) 
Seat 9: ari155863 (5558 in chips) 
Caio Mugarte: posts the ante 25
Rx_Kings: posts the ante 25
dp2122: posts the ante 25
stalin191137: posts the ante 25
Asildar: posts the ante 25
ari155863: posts the ante 25
ari155863: posts small blind 100
Caio Mugarte: posts big blind 200
*** HOLE CARDS ***
Dealt to Caio Mugarte [9c 9s]
Rx_Kings: folds 
dp2122: folds 
stalin191137: raises 200 to 400
Asildar: folds 
ari155863: folds 
Caio Mugarte: calls 200
*** FLOP *** [9d Ac 4h]
Caio Mugarte: checks 
stalin191137: bets 525
Caio Mugarte: calls 525
*** TURN *** [9d Ac 4h] [As]
Caio Mugarte: checks 
stalin191137: checks 
*** RIVER *** [9d Ac 4h As] [2h]
Caio Mugarte: bets 1000
stalin191137: folds 
Uncalled bet (1000) returned to Caio Mugarte
Caio Mugarte collected 2100 from pot
Caio Mugarte: doesn't show hand 
*** SUMMARY ***
Total pot 2100 | Rake 0 
Board [9d Ac 4h As 2h]
Seat 1: Caio Mugarte (big blind) collected (2100)
Seat 2: Rx_Kings folded before Flop (didn't bet)
Seat 4: dp2122 folded before Flop (didn't bet)
Seat 5: stalin191137 folded on the River
Seat 8: Asildar (button) folded before Flop (didn't bet)
Seat 9: ari155863 (small blind) folded before Flop



PokerStars Hand #245425836600: Tournament #3632163743, $0.23+$0.02 USD Hold'em No Limit - Level VII (100/200) - 2023/08/16 15:22:28 AT [2023/08/16 14:22:28 ET]
Table '3632163743 4' 9-max Seat #9 is the button
Seat 1: Caio Mugarte (7218 in chips) 
Seat 2: Rx_Kings (4431 in chips) 
Seat 4: dp2122 (9101 in chips) 
Seat 5: stalin191137 (4197 in chips) 
Seat 8: Asildar (12354 in chips) 
Seat 9: ari155863 (5433 in chips) 
Caio Mugarte: posts the ante 25
Rx_Kings: posts the ante 25
dp2122: posts the ante 25
stalin191137: posts the ante 25
Asildar: posts the ante 25
ari155863: posts the ante 25
Caio Mugarte: posts small blind 100
Rx_Kings: posts big blind 200
*** HOLE CARDS ***
Dealt to Caio Mugarte [Kc Jh]
dp2122: folds 
stalin191137: folds 
Asildar: folds 
ari155863: calls 200
Caio Mugarte: raises 600 to 800
Rx_Kings: folds 
ari155863: calls 600
*** FLOP *** [7h 5s 7c]
Caio Mugarte: checks 
ari155863: checks 
*** TURN *** [7h 5s 7c] [Ks]
Caio Mugarte: bets 600
ari155863: folds 
Uncalled bet (600) returned to Caio Mugarte
Caio Mugarte collected 1950 from pot
Caio Mugarte: doesn't show hand 
*** SUMMARY ***
Total pot 1950 | Rake 0 
Board [7h 5s 7c Ks]
Seat 1: Caio Mugarte (small blind) collected (1950)
Seat 2: Rx_Kings (big blind) folded before Flop
Seat 4: dp2122 folded before Flop (didn't bet)
Seat 5: stalin191137 folded before Flop (didn't bet)
Seat 8: Asildar folded before Flop (didn't bet)
Seat 9: ari155863 (button) folded on the Turn



PokerStars Hand #245425845111: Tournament #3632163743, $0.23+$0.02 USD Hold'em No Limit - Level VII (100/200) - 2023/08/16 15:22:57 AT [2023/08/16 14:22:57 ET]
Table '3632163743 4' 9-max Seat #1 is the button
Seat 1: Caio Mugarte (8343 in chips) 
Seat 2: Rx_Kings (4206 in chips) 
Seat 4: dp2122 (9076 in chips) 
Seat 5: stalin191137 (4172 in chips) 
Seat 8: Asildar (12329 in chips) 
Seat 9: ari155863 (4608 in chips) 
Caio Mugarte: posts the ante 25
Rx_Kings: posts the ante 25
dp2122: posts the ante 25
stalin191137: posts the ante 25
Asildar: posts the ante 25
ari155863: posts the ante 25
Rx_Kings: posts small blind 100
dp2122: posts big blind 200
*** HOLE CARDS ***
Dealt to Caio Mugarte [9c 8s]
stalin191137: folds 
Asildar: raises 200 to 400
ari155863: folds 
Caio Mugarte: folds 
Rx_Kings: folds 
dp2122: calls 200
*** FLOP *** [8d Tc 8h]
dp2122: checks 
Asildar: bets 515
dp2122: folds 
Uncalled bet (515) returned to Asildar
Asildar collected 1050 from pot
Asildar: doesn't show hand 
*** SUMMARY ***
Total pot 1050 | Rake 0 
Board [8d Tc 8h]
Seat 1: Caio Mugarte (button) folded before Flop (didn't bet)
Seat 2: Rx_Kings (small blind) folded before Flop
Seat 4: dp2122 (big blind) folded on the Flop
Seat 5: stalin191137 folded before Flop (didn't bet)
Seat 8: Asildar collected (1050)
Seat 9: ari155863 folded before Flop (didn't bet)



PokerStars Hand #245425851055: Tournament #3632163743, $0.23+$0.02 USD Hold'em No Limit - Level VII (100/200) - 2023/08/16 15:23:17 AT [2023/08/16 14:23:17 ET]
Table '3632163743 4' 9-max Seat #2 is the button
Seat 1: Caio Mugarte (8318 in chips) 
Seat 2: Rx_Kings (4081 in chips) 
Seat 4: dp2122 (8651 in chips) 
Seat 5: stalin191137 (4147 in chips) 
Seat 8: Asildar (12954 in chips) 
Seat 9: ari155863 (4583 in chips) 
Caio Mugarte: posts the ante 25
Rx_Kings: posts the ante 25
dp2122: posts the ante 25
stalin191137: posts the ante 25
Asildar: posts the ante 25
ari155863: posts the ante 25
dp2122: posts small blind 100
stalin191137: posts big blind 200
*** HOLE CARDS ***
Dealt to Caio Mugarte [7c Kd]
Asildar: folds 
ari155863: calls 200
Caio Mugarte: folds 
Rx_Kings: raises 300 to 500
dp2122: folds 
stalin191137: folds 
ari155863: calls 300
*** FLOP *** [4c 4s 3d]
ari155863: checks 
Rx_Kings: bets 1000
ari155863: raises 3058 to 4058 and is all-in
Rx_Kings: calls 2556 and is all-in
Uncalled bet (502) returned to ari155863
*** TURN *** [4c 4s 3d] [Kc]
*** RIVER *** [4c 4s 3d Kc] [9d]
*** SHOW DOWN ***
ari155863: shows [Ah 6d] (a pair of Fours)
Rx_Kings: shows [Kh Ks] (a full house, Kings full of Fours)
Rx_Kings collected 8562 from pot
*** SUMMARY ***
Total pot 8562 | Rake 0 
Board [4c 4s 3d Kc 9d]
Seat 1: Caio Mugarte folded before Flop (didn't bet)
Seat 2: Rx_Kings (button) showed [Kh Ks] and won (8562) with a full house, Kings full of Fours
Seat 4: dp2122 (small blind) folded before Flop
Seat 5: stalin191137 (big blind) folded before Flop
Seat 8: Asildar folded before Flop (didn't bet)
Seat 9: ari155863 showed [Ah 6d] and lost with a pair of Fours



PokerStars Hand #245425862478: Tournament #3632163743, $0.23+$0.02 USD Hold'em No Limit - Level VII (100/200) - 2023/08/16 15:23:55 AT [2023/08/16 14:23:55 ET]
Table '3632163743 4' 9-max Seat #4 is the button
Seat 1: Caio Mugarte (8293 in chips) 
Seat 2: Rx_Kings (8562 in chips) 
Seat 4: dp2122 (8526 in chips) 
Seat 5: stalin191137 (3922 in chips) 
Seat 8: Asildar (12929 in chips) 
Seat 9: ari155863 (502 in chips) 
Caio Mugarte: posts the ante 25
Rx_Kings: posts the ante 25
dp2122: posts the ante 25
stalin191137: posts the ante 25
Asildar: posts the ante 25
ari155863: posts the ante 25
stalin191137: posts small blind 100
Asildar: posts big blind 200
*** HOLE CARDS ***
Dealt to Caio Mugarte [Jh As]
ari155863: raises 277 to 477 and is all-in
Caio Mugarte: calls 477
Rx_Kings: folds 
dp2122: folds 
stalin191137: folds 
Asildar: calls 277
*** FLOP *** [8d Td 3s]
Asildar: checks 
Caio Mugarte: checks 
*** TURN *** [8d Td 3s] [2d]
Asildar: bets 1159
Caio Mugarte: folds 
Uncalled bet (1159) returned to Asildar
*** RIVER *** [8d Td 3s 2d] [9h]
*** SHOW DOWN ***
Asildar: shows [4s Th] (a pair of Tens)
ari155863: shows [Qs Ad] (high card Ace)
Asildar collected 1681 from pot
ari155863 finished the tournament in 11th place
*** SUMMARY ***
Total pot 1681 | Rake 0 
Board [8d Td 3s 2d 9h]
Seat 1: Caio Mugarte folded on the Turn
Seat 2: Rx_Kings folded before Flop (didn't bet)
Seat 4: dp2122 (button) folded before Flop (didn't bet)
Seat 5: stalin191137 (small blind) folded before Flop
Seat 8: Asildar (big blind) showed [4s Th] and won (1681) with a pair of Tens
Seat 9: ari155863 showed [Qs Ad] and lost with high card Ace



PokerStars Hand #245425873709: Tournament #3632163743, $0.23+$0.02 USD Hold'em No Limit - Level VIII (150/300) - 2023/08/16 15:24:33 AT [2023/08/16 14:24:33 ET]
Table '3632163743 4' 9-max Seat #5 is the button
Seat 1: Caio Mugarte (7791 in chips) 
Seat 2: Rx_Kings (8537 in chips) 
Seat 4: dp2122 (8501 in chips) 
Seat 5: stalin191137 (3797 in chips) 
Seat 8: Asildar (14108 in chips) 
Caio Mugarte: posts the ante 25
Rx_Kings: posts the ante 25
dp2122: posts the ante 25
stalin191137: posts the ante 25
Asildar: posts the ante 25
Asildar: posts small blind 150
Caio Mugarte: posts big blind 300
*** HOLE CARDS ***
Dealt to Caio Mugarte [9c 3c]
Rx_Kings: folds 
dp2122: calls 300
stalin191137: folds 
Asildar: calls 150
Caio Mugarte: checks 
*** FLOP *** [7s 5s 2d]
Asildar: bets 779
Caio Mugarte: folds 
dp2122: calls 779
*** TURN *** [7s 5s 2d] [Js]
Asildar: bets 1963
dp2122: calls 1963
*** RIVER *** [7s 5s 2d Js] [8c]
Asildar: bets 5550
dp2122: calls 5434 and is all-in
Uncalled bet (116) returned to Asildar
*** SHOW DOWN ***
Asildar: shows [2s 4s] (a flush, Jack high)
dp2122: shows [6s 6c] (a pair of Sixes)
Asildar collected 17377 from pot
dp2122 finished the tournament in 10th place
*** SUMMARY ***
Total pot 17377 | Rake 0 
Board [7s 5s 2d Js 8c]
Seat 1: Caio Mugarte (big blind) folded on the Flop
Seat 2: Rx_Kings folded before Flop (didn't bet)
Seat 4: dp2122 showed [6s 6c] and lost with a pair of Sixes
Seat 5: stalin191137 (button) folded before Flop (didn't bet)
Seat 8: Asildar (small blind) showed [2s 4s] and won (17377) with a flush, Jack high



PokerStars Hand #245425891363: Tournament #3632163743, $0.23+$0.02 USD Hold'em No Limit - Level VIII (150/300) - 2023/08/16 15:25:33 AT [2023/08/16 14:25:33 ET]
Table '3632163743 5' 9-max Seat #5 is the button
Seat 1: Caio Mugarte (7466 in chips) 
Seat 2: banane4711 (8879 in chips) 
Seat 3: Tallir (2300 in chips) 
Seat 4: didyk59 (2610 in chips) 
Seat 5: KaioPedro (2237 in chips) 
Seat 6: stalin191137 (3772 in chips) out of hand (moved from another table into small blind)
Seat 7: Rx_Kings (8512 in chips) out of hand (moved from another table into small blind)
Seat 8: Rosa885 (8740 in chips) 
Seat 9: Asildar (22984 in chips) 
stalin191137 will be allowed to play after the button
Rx_Kings will be allowed to play after the button
Caio Mugarte: posts the ante 25
banane4711: posts the ante 25
Tallir: posts the ante 25
didyk59: posts the ante 25
KaioPedro: posts the ante 25
Rosa885: posts the ante 25
Asildar: posts the ante 25
Rosa885: posts small blind 150
Asildar: posts big blind 300
*** HOLE CARDS ***
Dealt to Caio Mugarte [3d 2h]
Caio Mugarte: folds 
banane4711: folds 
Tallir: folds 
didyk59: folds 
KaioPedro: calls 300
Rosa885: folds 
Asildar: raises 2400 to 2700
KaioPedro: calls 1912 and is all-in
Uncalled bet (488) returned to Asildar
*** FLOP *** [4h Kh Kc]
*** TURN *** [4h Kh Kc] [3h]
*** RIVER *** [4h Kh Kc 3h] [Ks]
*** SHOW DOWN ***
Asildar: shows [2s Ah] (three of a kind, Kings)
KaioPedro: shows [7s As] (three of a kind, Kings - Ace+Seven kicker)
KaioPedro collected 4749 from pot
*** SUMMARY ***
Total pot 4749 | Rake 0 
Board [4h Kh Kc 3h Ks]
Seat 1: Caio Mugarte folded before Flop (didn't bet)
Seat 2: banane4711 folded before Flop (didn't bet)
Seat 3: Tallir folded before Flop (didn't bet)
Seat 4: didyk59 folded before Flop (didn't bet)
Seat 5: KaioPedro (button) showed [7s As] and won (4749) with three of a kind, Kings
Seat 8: Rosa885 (small blind) folded before Flop
Seat 9: Asildar (big blind) showed [2s Ah] and lost with three of a kind, Kings



PokerStars Hand #245425908035: Tournament #3632163743, $0.23+$0.02 USD Hold'em No Limit - Level VIII (150/300) - 2023/08/16 15:26:28 AT [2023/08/16 14:26:28 ET]
Table '3632163743 5' 9-max Seat #8 is the button
Seat 1: Caio Mugarte (7441 in chips) 
Seat 2: banane4711 (8854 in chips) 
Seat 3: Tallir (2275 in chips) 
Seat 4: didyk59 (2585 in chips) 
Seat 5: KaioPedro (4749 in chips) 
Seat 6: stalin191137 (3772 in chips) 
Seat 7: Rx_Kings (8512 in chips) 
Seat 8: Rosa885 (8565 in chips) 
Seat 9: Asildar (20747 in chips) 
Caio Mugarte: posts the ante 25
banane4711: posts the ante 25
Tallir: posts the ante 25
didyk59: posts the ante 25
KaioPedro: posts the ante 25
stalin191137: posts the ante 25
Rx_Kings: posts the ante 25
Rosa885: posts the ante 25
Asildar: posts the ante 25
Asildar: posts small blind 150
Caio Mugarte: posts big blind 300
*** HOLE CARDS ***
Dealt to Caio Mugarte [2h Jd]
banane4711: folds 
Tallir: folds 
didyk59: folds 
KaioPedro: folds 
stalin191137: folds 
Rx_Kings: folds 
Rosa885: raises 300 to 600
Asildar: folds 
Caio Mugarte: folds 
Uncalled bet (300) returned to Rosa885
Rosa885 collected 975 from pot
*** SUMMARY ***
Total pot 975 | Rake 0 
Seat 1: Caio Mugarte (big blind) folded before Flop
Seat 2: banane4711 folded before Flop (didn't bet)
Seat 3: Tallir folded before Flop (didn't bet)
Seat 4: didyk59 folded before Flop (didn't bet)
Seat 5: KaioPedro folded before Flop (didn't bet)
Seat 6: stalin191137 folded before Flop (didn't bet)
Seat 7: Rx_Kings folded before Flop (didn't bet)
Seat 8: Rosa885 (button) collected (975)
Seat 9: Asildar (small blind) folded before Flop



PokerStars Hand #245425917067: Tournament #3632163743, $0.23+$0.02 USD Hold'em No Limit - Level VIII (150/300) - 2023/08/16 15:26:58 AT [2023/08/16 14:26:58 ET]
Table '3632163743 5' 9-max Seat #9 is the button
Seat 1: Caio Mugarte (7116 in chips) 
Seat 2: banane4711 (8829 in chips) 
Seat 3: Tallir (2250 in chips) 
Seat 4: didyk59 (2560 in chips) 
Seat 5: KaioPedro (4724 in chips) 
Seat 6: stalin191137 (3747 in chips) 
Seat 7: Rx_Kings (8487 in chips) 
Seat 8: Rosa885 (9215 in chips) 
Seat 9: Asildar (20572 in chips) 
Caio Mugarte: posts the ante 25
banane4711: posts the ante 25
Tallir: posts the ante 25
didyk59: posts the ante 25
KaioPedro: posts the ante 25
stalin191137: posts the ante 25
Rx_Kings: posts the ante 25
Rosa885: posts the ante 25
Asildar: posts the ante 25
Caio Mugarte: posts small blind 150
banane4711: posts big blind 300
*** HOLE CARDS ***
Dealt to Caio Mugarte [7s 4d]
Tallir: folds 
didyk59: folds 
KaioPedro: folds 
stalin191137: folds 
Rx_Kings: raises 450 to 750
Rosa885: folds 
Asildar: calls 750
Caio Mugarte: folds 
banane4711: calls 450
*** FLOP *** [5c Td Ad]
banane4711: checks 
Rx_Kings: checks 
Asildar: checks 
*** TURN *** [5c Td Ad] [Th]
banane4711: checks 
Rx_Kings: checks 
Asildar: bets 780
banane4711: folds 
Rx_Kings: calls 780
*** RIVER *** [5c Td Ad Th] [7d]
Rx_Kings: checks 
Asildar: checks 
*** SHOW DOWN ***
Rx_Kings: shows [Ah Kh] (two pair, Aces and Tens)
Asildar: mucks hand 
Rx_Kings collected 4185 from pot
*** SUMMARY ***
Total pot 4185 | Rake 0 
Board [5c Td Ad Th 7d]
Seat 1: Caio Mugarte (small blind) folded before Flop
Seat 2: banane4711 (big blind) folded on the Turn
Seat 3: Tallir folded before Flop (didn't bet)
Seat 4: didyk59 folded before Flop (didn't bet)
Seat 5: KaioPedro folded before Flop (didn't bet)
Seat 6: stalin191137 folded before Flop (didn't bet)
Seat 7: Rx_Kings showed [Ah Kh] and won (4185) with two pair, Aces and Tens
Seat 8: Rosa885 folded before Flop (didn't bet)
Seat 9: Asildar (button) mucked [Ks 6s]



PokerStars Hand #245425935190: Tournament #3632163743, $0.23+$0.02 USD Hold'em No Limit - Level VIII (150/300) - 2023/08/16 15:27:59 AT [2023/08/16 14:27:59 ET]
Table '3632163743 5' 9-max Seat #1 is the button
Seat 1: Caio Mugarte (6941 in chips) 
Seat 2: banane4711 (8054 in chips) 
Seat 3: Tallir (2225 in chips) 
Seat 4: didyk59 (2535 in chips) 
Seat 5: KaioPedro (4699 in chips) 
Seat 6: stalin191137 (3722 in chips) 
Seat 7: Rx_Kings (11117 in chips) 
Seat 8: Rosa885 (9190 in chips) 
Seat 9: Asildar (19017 in chips) 
Caio Mugarte: posts the ante 25
banane4711: posts the ante 25
Tallir: posts the ante 25
didyk59: posts the ante 25
KaioPedro: posts the ante 25
stalin191137: posts the ante 25
Rx_Kings: posts the ante 25
Rosa885: posts the ante 25
Asildar: posts the ante 25
banane4711: posts small blind 150
Tallir: posts big blind 300
*** HOLE CARDS ***
Dealt to Caio Mugarte [8h Jc]
didyk59: folds 
KaioPedro: folds 
stalin191137: folds 
Rx_Kings: folds 
Rosa885: folds 
Asildar: folds 
Caio Mugarte: raises 300 to 600
banane4711: folds 
Tallir: folds 
Uncalled bet (300) returned to Caio Mugarte
Caio Mugarte collected 975 from pot
Caio Mugarte: doesn't show hand 
*** SUMMARY ***
Total pot 975 | Rake 0 
Seat 1: Caio Mugarte (button) collected (975)
Seat 2: banane4711 (small blind) folded before Flop
Seat 3: Tallir (big blind) folded before Flop
Seat 4: didyk59 folded before Flop (didn't bet)
Seat 5: KaioPedro folded before Flop (didn't bet)
Seat 6: stalin191137 folded before Flop (didn't bet)
Seat 7: Rx_Kings folded before Flop (didn't bet)
Seat 8: Rosa885 folded before Flop (didn't bet)
Seat 9: Asildar folded before Flop (didn't bet)



PokerStars Hand #245425943362: Tournament #3632163743, $0.23+$0.02 USD Hold'em No Limit - Level VIII (150/300) - 2023/08/16 15:28:26 AT [2023/08/16 14:28:26 ET]
Table '3632163743 5' 9-max Seat #2 is the button
Seat 1: Caio Mugarte (7591 in chips) 
Seat 2: banane4711 (7879 in chips) 
Seat 3: Tallir (1900 in chips) 
Seat 4: didyk59 (2510 in chips) 
Seat 5: KaioPedro (4674 in chips) 
Seat 6: stalin191137 (3697 in chips) 
Seat 7: Rx_Kings (11092 in chips) 
Seat 8: Rosa885 (9165 in chips) 
Seat 9: Asildar (18992 in chips) 
Caio Mugarte: posts the ante 25
banane4711: posts the ante 25
Tallir: posts the ante 25
didyk59: posts the ante 25
KaioPedro: posts the ante 25
stalin191137: posts the ante 25
Rx_Kings: posts the ante 25
Rosa885: posts the ante 25
Asildar: posts the ante 25
Tallir: posts small blind 150
didyk59: posts big blind 300
*** HOLE CARDS ***
Dealt to Caio Mugarte [9c 4s]
KaioPedro: folds 
stalin191137: folds 
Rx_Kings: folds 
Rosa885: folds 
Asildar: folds 
Caio Mugarte: folds 
banane4711: raises 600 to 900
Tallir: folds 
didyk59: folds 
Uncalled bet (600) returned to banane4711
banane4711 collected 975 from pot
banane4711: doesn't show hand 
*** SUMMARY ***
Total pot 975 | Rake 0 
Seat 1: Caio Mugarte folded before Flop (didn't bet)
Seat 2: banane4711 (button) collected (975)
Seat 3: Tallir (small blind) folded before Flop
Seat 4: didyk59 (big blind) folded before Flop
Seat 5: KaioPedro folded before Flop (didn't bet)
Seat 6: stalin191137 folded before Flop (didn't bet)
Seat 7: Rx_Kings folded before Flop (didn't bet)
Seat 8: Rosa885 folded before Flop (didn't bet)
Seat 9: Asildar folded before Flop (didn't bet)



PokerStars Hand #245425949836: Tournament #3632163743, $0.23+$0.02 USD Hold'em No Limit - Level VIII (150/300) - 2023/08/16 15:28:47 AT [2023/08/16 14:28:47 ET]
Table '3632163743 5' 9-max Seat #3 is the button
Seat 1: Caio Mugarte (7566 in chips) 
Seat 2: banane4711 (8529 in chips) 
Seat 3: Tallir (1725 in chips) 
Seat 4: didyk59 (2185 in chips) 
Seat 5: KaioPedro (4649 in chips) 
Seat 6: stalin191137 (3672 in chips) 
Seat 7: Rx_Kings (11067 in chips) 
Seat 8: Rosa885 (9140 in chips) 
Seat 9: Asildar (18967 in chips) 
Caio Mugarte: posts the ante 25
banane4711: posts the ante 25
Tallir: posts the ante 25
didyk59: posts the ante 25
KaioPedro: posts the ante 25
stalin191137: posts the ante 25
Rx_Kings: posts the ante 25
Rosa885: posts the ante 25
Asildar: posts the ante 25
didyk59: posts small blind 150
KaioPedro: posts big blind 300
*** HOLE CARDS ***
Dealt to Caio Mugarte [Ac 5h]
stalin191137: raises 3347 to 3647 and is all-in
Rx_Kings: folds 
Rosa885 has timed out
Rosa885: folds 
Rosa885 is sitting out
Asildar: folds 
Caio Mugarte: folds 
banane4711: folds 
Tallir: folds 
didyk59: folds 
KaioPedro: folds 
Uncalled bet (3347) returned to stalin191137
stalin191137 collected 975 from pot
stalin191137: doesn't show hand 
*** SUMMARY ***
Total pot 975 | Rake 0 
Seat 1: Caio Mugarte folded before Flop (didn't bet)
Seat 2: banane4711 folded before Flop (didn't bet)
Seat 3: Tallir (button) folded before Flop (didn't bet)
Seat 4: didyk59 (small blind) folded before Flop
Seat 5: KaioPedro (big blind) folded before Flop
Seat 6: stalin191137 collected (975)
Seat 7: Rx_Kings folded before Flop (didn't bet)
Seat 8: Rosa885 folded before Flop (didn't bet)
Seat 9: Asildar folded before Flop (didn't bet)



PokerStars Hand #245425966231: Tournament #3632163743, $0.23+$0.02 USD Hold'em No Limit - Level VIII (150/300) - 2023/08/16 15:29:42 AT [2023/08/16 14:29:42 ET]
Table '3632163743 5' 9-max Seat #4 is the button
Seat 1: Caio Mugarte (7541 in chips) 
Seat 2: banane4711 (8504 in chips) 
Seat 3: Tallir (1700 in chips) 
Seat 4: didyk59 (2010 in chips) 
Seat 5: KaioPedro (4324 in chips) 
Seat 6: stalin191137 (4322 in chips) 
Seat 7: Rx_Kings (11042 in chips) 
Seat 8: Rosa885 (9115 in chips) is sitting out
Seat 9: Asildar (18942 in chips) 
Caio Mugarte: posts the ante 25
banane4711: posts the ante 25
Tallir: posts the ante 25
didyk59: posts the ante 25
KaioPedro: posts the ante 25
stalin191137: posts the ante 25
Rx_Kings: posts the ante 25
Rosa885: posts the ante 25
Asildar: posts the ante 25
KaioPedro: posts small blind 150
stalin191137: posts big blind 300
*** HOLE CARDS ***
Dealt to Caio Mugarte [Tc Js]
Rx_Kings: folds 
Rosa885: folds 
Asildar: folds 
Caio Mugarte: raises 300 to 600
Rosa885 has returned
banane4711: folds 
Tallir: folds 
didyk59: raises 1385 to 1985 and is all-in
KaioPedro: folds 
stalin191137: folds 
Caio Mugarte: calls 1385
*** FLOP *** [2d 9s Ts]
*** TURN *** [2d 9s Ts] [8h]
*** RIVER *** [2d 9s Ts 8h] [4s]
*** SHOW DOWN ***
Caio Mugarte: shows [Tc Js] (a pair of Tens)
didyk59: shows [Jc Jd] (a pair of Jacks)
didyk59 collected 4645 from pot
*** SUMMARY ***
Total pot 4645 | Rake 0 
Board [2d 9s Ts 8h 4s]
Seat 1: Caio Mugarte showed [Tc Js] and lost with a pair of Tens
Seat 2: banane4711 folded before Flop (didn't bet)
Seat 3: Tallir folded before Flop (didn't bet)
Seat 4: didyk59 (button) showed [Jc Jd] and won (4645) with a pair of Jacks
Seat 5: KaioPedro (small blind) folded before Flop
Seat 6: stalin191137 (big blind) folded before Flop
Seat 7: Rx_Kings folded before Flop (didn't bet)
Seat 8: Rosa885 folded before Flop (didn't bet)
Seat 9: Asildar folded before Flop (didn't bet)



PokerStars Hand #245425985253: Tournament #3632163743, $0.23+$0.02 USD Hold'em No Limit - Level VIII (150/300) - 2023/08/16 15:30:44 AT [2023/08/16 14:30:44 ET]
Table '3632163743 5' 9-max Seat #5 is the button
Seat 1: Caio Mugarte (5531 in chips) 
Seat 2: banane4711 (8479 in chips) 
Seat 3: Tallir (1675 in chips) 
Seat 4: didyk59 (4645 in chips) 
Seat 5: KaioPedro (4149 in chips) 
Seat 6: stalin191137 (3997 in chips) 
Seat 7: Rx_Kings (11017 in chips) 
Seat 8: Rosa885 (9090 in chips) 
Seat 9: Asildar (18917 in chips) 
Caio Mugarte: posts the ante 25
banane4711: posts the ante 25
Tallir: posts the ante 25
didyk59: posts the ante 25
KaioPedro: posts the ante 25
stalin191137: posts the ante 25
Rx_Kings: posts the ante 25
Rosa885: posts the ante 25
Asildar: posts the ante 25
stalin191137: posts small blind 150
Rx_Kings: posts big blind 300
*** HOLE CARDS ***
Dealt to Caio Mugarte [4d 5c]
Rosa885: folds 
Asildar: raises 300 to 600
Caio Mugarte: folds 
banane4711: folds 
Tallir: raises 1050 to 1650 and is all-in
didyk59: folds 
KaioPedro: folds 
stalin191137: folds 
Rx_Kings: folds 
Asildar: calls 1050
*** FLOP *** [2s 2d 3s]
*** TURN *** [2s 2d 3s] [9s]
*** RIVER *** [2s 2d 3s 9s] [6h]
*** SHOW DOWN ***
Asildar: shows [Kc Qh] (a pair of Deuces)
Tallir: shows [As 9h] (two pair, Nines and Deuces)
Tallir collected 3975 from pot
*** SUMMARY ***
Total pot 3975 | Rake 0 
Board [2s 2d 3s 9s 6h]
Seat 1: Caio Mugarte folded before Flop (didn't bet)
Seat 2: banane4711 folded before Flop (didn't bet)
Seat 3: Tallir showed [As 9h] and won (3975) with two pair, Nines and Deuces
Seat 4: didyk59 folded before Flop (didn't bet)
Seat 5: KaioPedro (button) folded before Flop (didn't bet)
Seat 6: stalin191137 (small blind) folded before Flop
Seat 7: Rx_Kings (big blind) folded before Flop
Seat 8: Rosa885 folded before Flop (didn't bet)
Seat 9: Asildar showed [Kc Qh] and lost with a pair of Deuces



PokerStars Hand #245426002558: Tournament #3632163743, $0.23+$0.02 USD Hold'em No Limit - Level VIII (150/300) - 2023/08/16 15:31:42 AT [2023/08/16 14:31:42 ET]
Table '3632163743 5' 9-max Seat #6 is the button
Seat 1: Caio Mugarte (5506 in chips) 
Seat 2: banane4711 (8454 in chips) 
Seat 3: Tallir (3975 in chips) 
Seat 4: didyk59 (4620 in chips) 
Seat 5: KaioPedro (4124 in chips) 
Seat 6: stalin191137 (3822 in chips) 
Seat 7: Rx_Kings (10692 in chips) 
Seat 8: Rosa885 (9065 in chips) 
Seat 9: Asildar (17242 in chips) 
Caio Mugarte: posts the ante 25
banane4711: posts the ante 25
Tallir: posts the ante 25
didyk59: posts the ante 25
KaioPedro: posts the ante 25
stalin191137: posts the ante 25
Rx_Kings: posts the ante 25
Rosa885: posts the ante 25
Asildar: posts the ante 25
Rx_Kings: posts small blind 150
Rosa885: posts big blind 300
*** HOLE CARDS ***
Dealt to Caio Mugarte [3c 9c]
Asildar: folds 
Caio Mugarte: folds 
banane4711: folds 
Tallir: calls 300
didyk59: folds 
KaioPedro: folds 
stalin191137: folds 
Rx_Kings: calls 150
Rosa885: checks 
*** FLOP *** [5s 6d Ah]
Rx_Kings: checks 
Rosa885: checks 
Tallir: bets 300
Rx_Kings: folds 
Rosa885: calls 300
*** TURN *** [5s 6d Ah] [8d]
Rosa885: checks 
Tallir: bets 300
Rosa885: calls 300
*** RIVER *** [5s 6d Ah 8d] [Ad]
Rosa885: bets 1488
Tallir: folds 
Uncalled bet (1488) returned to Rosa885
Rosa885 collected 2325 from pot
*** SUMMARY ***
Total pot 2325 | Rake 0 
Board [5s 6d Ah 8d Ad]
Seat 1: Caio Mugarte folded before Flop (didn't bet)
Seat 2: banane4711 folded before Flop (didn't bet)
Seat 3: Tallir folded on the River
Seat 4: didyk59 folded before Flop (didn't bet)
Seat 5: KaioPedro folded before Flop (didn't bet)
Seat 6: stalin191137 (button) folded before Flop (didn't bet)
Seat 7: Rx_Kings (small blind) folded on the Flop
Seat 8: Rosa885 (big blind) collected (2325)
Seat 9: Asildar folded before Flop (didn't bet)



PokerStars Hand #245426023201: Tournament #3632163743, $0.23+$0.02 USD Hold'em No Limit - Level VIII (150/300) - 2023/08/16 15:32:51 AT [2023/08/16 14:32:51 ET]
Table '3632163743 5' 9-max Seat #7 is the button
Seat 1: Caio Mugarte (5481 in chips) 
Seat 2: banane4711 (8429 in chips) 
Seat 3: Tallir (3050 in chips) 
Seat 4: didyk59 (4595 in chips) 
Seat 5: KaioPedro (4099 in chips) 
Seat 6: stalin191137 (3797 in chips) 
Seat 7: Rx_Kings (10367 in chips) 
Seat 8: Rosa885 (10465 in chips) 
Seat 9: Asildar (17217 in chips) 
Caio Mugarte: posts the ante 25
banane4711: posts the ante 25
Tallir: posts the ante 25
didyk59: posts the ante 25
KaioPedro: posts the ante 25
stalin191137: posts the ante 25
Rx_Kings: posts the ante 25
Rosa885: posts the ante 25
Asildar: posts the ante 25
Rosa885: posts small blind 150
Asildar: posts big blind 300
*** HOLE CARDS ***
Dealt to Caio Mugarte [2d 6s]
Caio Mugarte: folds 
banane4711: folds 
Tallir: folds 
didyk59: folds 
KaioPedro: raises 300 to 600
stalin191137: folds 
Rx_Kings: folds 
Rosa885: folds 
Asildar: calls 300
*** FLOP *** [9h 9s Td]
Asildar: checks 
KaioPedro: bets 473
Asildar: folds 
Uncalled bet (473) returned to KaioPedro
KaioPedro collected 1575 from pot
KaioPedro: doesn't show hand 
*** SUMMARY ***
Total pot 1575 | Rake 0 
Board [9h 9s Td]
Seat 1: Caio Mugarte folded before Flop (didn't bet)
Seat 2: banane4711 folded before Flop (didn't bet)
Seat 3: Tallir folded before Flop (didn't bet)
Seat 4: didyk59 folded before Flop (didn't bet)
Seat 5: KaioPedro collected (1575)
Seat 6: stalin191137 folded before Flop (didn't bet)
Seat 7: Rx_Kings (button) folded before Flop (didn't bet)
Seat 8: Rosa885 (small blind) folded before Flop
Seat 9: Asildar (big blind) folded on the Flop



PokerStars Hand #245426034835: Tournament #3632163743, $0.23+$0.02 USD Hold'em No Limit - Level VIII (150/300) - 2023/08/16 15:33:30 AT [2023/08/16 14:33:30 ET]
Table '3632163743 5' 9-max Seat #8 is the button
Seat 1: Caio Mugarte (5456 in chips) 
Seat 2: banane4711 (8404 in chips) 
Seat 3: Tallir (3025 in chips) 
Seat 4: didyk59 (4570 in chips) 
Seat 5: KaioPedro (5049 in chips) 
Seat 6: stalin191137 (3772 in chips) 
Seat 7: Rx_Kings (10342 in chips) 
Seat 8: Rosa885 (10290 in chips) 
Seat 9: Asildar (16592 in chips) 
Caio Mugarte: posts the ante 25
banane4711: posts the ante 25
Tallir: posts the ante 25
didyk59: posts the ante 25
KaioPedro: posts the ante 25
stalin191137: posts the ante 25
Rx_Kings: posts the ante 25
Rosa885: posts the ante 25
Asildar: posts the ante 25
Asildar: posts small blind 150
Caio Mugarte: posts big blind 300
*** HOLE CARDS ***
Dealt to Caio Mugarte [5s 9h]
banane4711 has timed out
banane4711: folds 
banane4711 is sitting out
banane4711 has returned
Tallir: folds 
didyk59: folds 
KaioPedro: raises 300 to 600
stalin191137: folds 
Rx_Kings: folds 
Rosa885: folds 
Asildar: raises 15967 to 16567 and is all-in
Caio Mugarte: folds 
KaioPedro: calls 4424 and is all-in
Uncalled bet (11543) returned to Asildar
*** FLOP *** [Ac 5c 6d]
*** TURN *** [Ac 5c 6d] [4c]
*** RIVER *** [Ac 5c 6d 4c] [8c]
*** SHOW DOWN ***
Asildar: shows [5h 5d] (three of a kind, Fives)
KaioPedro: shows [Qh Ks] (high card Ace)
Asildar collected 10573 from pot
KaioPedro finished the tournament in 9th place
*** SUMMARY ***
Total pot 10573 | Rake 0 
Board [Ac 5c 6d 4c 8c]
Seat 1: Caio Mugarte (big blind) folded before Flop
Seat 2: banane4711 folded before Flop (didn't bet)
Seat 3: Tallir folded before Flop (didn't bet)
Seat 4: didyk59 folded before Flop (didn't bet)
Seat 5: KaioPedro showed [Qh Ks] and lost with high card Ace
Seat 6: stalin191137 folded before Flop (didn't bet)
Seat 7: Rx_Kings folded before Flop (didn't bet)
Seat 8: Rosa885 (button) folded before Flop (didn't bet)
Seat 9: Asildar (small blind) showed [5h 5d] and won (10573) with three of a kind, Fives



PokerStars Hand #245426053806: Tournament #3632163743, $0.23+$0.02 USD Hold'em No Limit - Level IX (200/400) - 2023/08/16 15:34:33 AT [2023/08/16 14:34:33 ET]
Table '3632163743 5' 9-max Seat #9 is the button
Seat 1: Caio Mugarte (5131 in chips) 
Seat 2: banane4711 (8379 in chips) 
Seat 3: Tallir (3000 in chips) 
Seat 4: didyk59 (4545 in chips) 
Seat 6: stalin191137 (3747 in chips) 
Seat 7: Rx_Kings (10317 in chips) 
Seat 8: Rosa885 (10265 in chips) 
Seat 9: Asildar (22116 in chips) 
Caio Mugarte: posts the ante 25
banane4711: posts the ante 25
Tallir: posts the ante 25
didyk59: posts the ante 25
stalin191137: posts the ante 25
Rx_Kings: posts the ante 25
Rosa885: posts the ante 25
Asildar: posts the ante 25
Caio Mugarte: posts small blind 200
banane4711: posts big blind 400
*** HOLE CARDS ***
Dealt to Caio Mugarte [8h 2h]
Tallir: folds 
didyk59: folds 
stalin191137: folds 
Rx_Kings: folds 
Rosa885: calls 400
Asildar: folds 
Caio Mugarte: folds 
banane4711: checks 
*** FLOP *** [5h Kd 2c]
banane4711: checks 
Rosa885: checks 
*** TURN *** [5h Kd 2c] [3d]
banane4711: checks 
Rosa885: checks 
*** RIVER *** [5h Kd 2c 3d] [5s]
banane4711: checks 
Rosa885: checks 
*** SHOW DOWN ***
banane4711: shows [Qs 9d] (a pair of Fives)
Rosa885: shows [Qh Ah] (a pair of Fives - Ace kicker)
Rosa885 collected 1200 from pot
*** SUMMARY ***
Total pot 1200 | Rake 0 
Board [5h Kd 2c 3d 5s]
Seat 1: Caio Mugarte (small blind) folded before Flop
Seat 2: banane4711 (big blind) showed [Qs 9d] and lost with a pair of Fives
Seat 3: Tallir folded before Flop (didn't bet)
Seat 4: didyk59 folded before Flop (didn't bet)
Seat 6: stalin191137 folded before Flop (didn't bet)
Seat 7: Rx_Kings folded before Flop (didn't bet)
Seat 8: Rosa885 showed [Qh Ah] and won (1200) with a pair of Fives
Seat 9: Asildar (button) folded before Flop (didn't bet)



PokerStars Hand #245426072894: Tournament #3632163743, $0.23+$0.02 USD Hold'em No Limit - Level IX (200/400) - 2023/08/16 15:35:36 AT [2023/08/16 14:35:36 ET]
Table '3632163743 5' 9-max Seat #1 is the button
Seat 1: Caio Mugarte (4906 in chips) 
Seat 2: banane4711 (7954 in chips) 
Seat 3: Tallir (2975 in chips) 
Seat 4: didyk59 (4520 in chips) 
Seat 6: stalin191137 (3722 in chips) 
Seat 7: Rx_Kings (10292 in chips) 
Seat 8: Rosa885 (11040 in chips) 
Seat 9: Asildar (22091 in chips) 
Caio Mugarte: posts the ante 25
banane4711: posts the ante 25
Tallir: posts the ante 25
didyk59: posts the ante 25
stalin191137: posts the ante 25
Rx_Kings: posts the ante 25
Rosa885: posts the ante 25
Asildar: posts the ante 25
banane4711: posts small blind 200
Tallir: posts big blind 400
*** HOLE CARDS ***
Dealt to Caio Mugarte [6c 5h]
didyk59: folds 
stalin191137: folds 
Rx_Kings: folds 
Rosa885: folds 
Asildar: folds 
Caio Mugarte: folds 
banane4711: raises 7529 to 7929 and is all-in
Tallir: folds 
Uncalled bet (7529) returned to banane4711
banane4711 collected 1000 from pot
banane4711: doesn't show hand 
*** SUMMARY ***
Total pot 1000 | Rake 0 
Seat 1: Caio Mugarte (button) folded before Flop (didn't bet)
Seat 2: banane4711 (small blind) collected (1000)
Seat 3: Tallir (big blind) folded before Flop
Seat 4: didyk59 folded before Flop (didn't bet)
Seat 6: stalin191137 folded before Flop (didn't bet)
Seat 7: Rx_Kings folded before Flop (didn't bet)
Seat 8: Rosa885 folded before Flop (didn't bet)
Seat 9: Asildar folded before Flop (didn't bet)



PokerStars Hand #245426080772: Tournament #3632163743, $0.23+$0.02 USD Hold'em No Limit - Level IX (200/400) - 2023/08/16 15:36:02 AT [2023/08/16 14:36:02 ET]
Table '3632163743 5' 9-max Seat #2 is the button
Seat 1: Caio Mugarte (4881 in chips) 
Seat 2: banane4711 (8529 in chips) 
Seat 3: Tallir (2550 in chips) 
Seat 4: didyk59 (4495 in chips) 
Seat 6: stalin191137 (3697 in chips) 
Seat 7: Rx_Kings (10267 in chips) 
Seat 8: Rosa885 (11015 in chips) 
Seat 9: Asildar (22066 in chips) 
Caio Mugarte: posts the ante 25
banane4711: posts the ante 25
Tallir: posts the ante 25
didyk59: posts the ante 25
stalin191137: posts the ante 25
Rx_Kings: posts the ante 25
Rosa885: posts the ante 25
Asildar: posts the ante 25
Tallir: posts small blind 200
didyk59: posts big blind 400
*** HOLE CARDS ***
Dealt to Caio Mugarte [4h Ks]
stalin191137: folds 
Rx_Kings: folds 
Rosa885: folds 
Asildar: raises 400 to 800
Caio Mugarte: folds 
banane4711 has timed out
banane4711: folds 
banane4711 is sitting out
banane4711 has returned
Tallir: folds 
didyk59: folds 
Uncalled bet (400) returned to Asildar
Asildar collected 1200 from pot
Asildar: doesn't show hand 
*** SUMMARY ***
Total pot 1200 | Rake 0 
Seat 1: Caio Mugarte folded before Flop (didn't bet)
Seat 2: banane4711 (button) folded before Flop (didn't bet)
Seat 3: Tallir (small blind) folded before Flop
Seat 4: didyk59 (big blind) folded before Flop
Seat 6: stalin191137 folded before Flop (didn't bet)
Seat 7: Rx_Kings folded before Flop (didn't bet)
Seat 8: Rosa885 folded before Flop (didn't bet)
Seat 9: Asildar collected (1200)



PokerStars Hand #245426089207: Tournament #3632163743, $0.23+$0.02 USD Hold'em No Limit - Level IX (200/400) - 2023/08/16 15:36:30 AT [2023/08/16 14:36:30 ET]
Table '3632163743 5' 9-max Seat #3 is the button
Seat 1: Caio Mugarte (4856 in chips) 
Seat 2: banane4711 (8504 in chips) 
Seat 3: Tallir (2325 in chips) 
Seat 4: didyk59 (4070 in chips) 
Seat 6: stalin191137 (3672 in chips) 
Seat 7: Rx_Kings (10242 in chips) 
Seat 8: Rosa885 (10990 in chips) 
Seat 9: Asildar (22841 in chips) 
Caio Mugarte: posts the ante 25
banane4711: posts the ante 25
Tallir: posts the ante 25
didyk59: posts the ante 25
stalin191137: posts the ante 25
Rx_Kings: posts the ante 25
Rosa885: posts the ante 25
Asildar: posts the ante 25
didyk59: posts small blind 200
stalin191137: posts big blind 400
*** HOLE CARDS ***
Dealt to Caio Mugarte [Ts Qs]
Rx_Kings: folds 
Rosa885: folds 
Asildar: raises 22416 to 22816 and is all-in
Caio Mugarte: folds 
banane4711: folds 
Tallir: folds 
didyk59: folds 
stalin191137: folds 
Uncalled bet (22416) returned to Asildar
Asildar collected 1200 from pot
Asildar: doesn't show hand 
*** SUMMARY ***
Total pot 1200 | Rake 0 
Seat 1: Caio Mugarte folded before Flop (didn't bet)
Seat 2: banane4711 folded before Flop (didn't bet)
Seat 3: Tallir (button) folded before Flop (didn't bet)
Seat 4: didyk59 (small blind) folded before Flop
Seat 6: stalin191137 (big blind) folded before Flop
Seat 7: Rx_Kings folded before Flop (didn't bet)
Seat 8: Rosa885 folded before Flop (didn't bet)
Seat 9: Asildar collected (1200)



PokerStars Hand #245426098007: Tournament #3632163743, $0.23+$0.02 USD Hold'em No Limit - Level IX (200/400) - 2023/08/16 15:36:59 AT [2023/08/16 14:36:59 ET]
Table '3632163743 5' 9-max Seat #4 is the button
Seat 1: Caio Mugarte (4831 in chips) 
Seat 2: banane4711 (8479 in chips) 
Seat 3: Tallir (2300 in chips) 
Seat 4: didyk59 (3845 in chips) 
Seat 6: stalin191137 (3247 in chips) 
Seat 7: Rx_Kings (10217 in chips) 
Seat 8: Rosa885 (10965 in chips) 
Seat 9: Asildar (23616 in chips) 
Caio Mugarte: posts the ante 25
banane4711: posts the ante 25
Tallir: posts the ante 25
didyk59: posts the ante 25
stalin191137: posts the ante 25
Rx_Kings: posts the ante 25
Rosa885: posts the ante 25
Asildar: posts the ante 25
stalin191137: posts small blind 200
Rx_Kings: posts big blind 400
*** HOLE CARDS ***
Dealt to Caio Mugarte [Ks 2h]
Rosa885: folds 
Asildar: folds 
Caio Mugarte: folds 
banane4711: folds 
Tallir: folds 
didyk59: folds 
stalin191137: raises 2822 to 3222 and is all-in
Rx_Kings: folds 
Uncalled bet (2822) returned to stalin191137
stalin191137 collected 1000 from pot
stalin191137: doesn't show hand 
*** SUMMARY ***
Total pot 1000 | Rake 0 
Seat 1: Caio Mugarte folded before Flop (didn't bet)
Seat 2: banane4711 folded before Flop (didn't bet)
Seat 3: Tallir folded before Flop (didn't bet)
Seat 4: didyk59 (button) folded before Flop (didn't bet)
Seat 6: stalin191137 (small blind) collected (1000)
Seat 7: Rx_Kings (big blind) folded before Flop
Seat 8: Rosa885 folded before Flop (didn't bet)
Seat 9: Asildar folded before Flop (didn't bet)



PokerStars Hand #245426105717: Tournament #3632163743, $0.23+$0.02 USD Hold'em No Limit - Level IX (200/400) - 2023/08/16 15:37:25 AT [2023/08/16 14:37:25 ET]
Table '3632163743 5' 9-max Seat #6 is the button
Seat 1: Caio Mugarte (4806 in chips) 
Seat 2: banane4711 (8454 in chips) 
Seat 3: Tallir (2275 in chips) 
Seat 4: didyk59 (3820 in chips) 
Seat 6: stalin191137 (3822 in chips) 
Seat 7: Rx_Kings (9792 in chips) 
Seat 8: Rosa885 (10940 in chips) 
Seat 9: Asildar (23591 in chips) 
Caio Mugarte: posts the ante 25
banane4711: posts the ante 25
Tallir: posts the ante 25
didyk59: posts the ante 25
stalin191137: posts the ante 25
Rx_Kings: posts the ante 25
Rosa885: posts the ante 25
Asildar: posts the ante 25
Rx_Kings: posts small blind 200
Rosa885: posts big blind 400
*** HOLE CARDS ***
Dealt to Caio Mugarte [Tc 5s]
Asildar: folds 
Caio Mugarte: folds 
banane4711: raises 8029 to 8429 and is all-in
Tallir: folds 
didyk59: folds 
stalin191137: folds 
Rx_Kings: folds 
Rosa885: folds 
Uncalled bet (8029) returned to banane4711
banane4711 collected 1200 from pot
banane4711: doesn't show hand 
*** SUMMARY ***
Total pot 1200 | Rake 0 
Seat 1: Caio Mugarte folded before Flop (didn't bet)
Seat 2: banane4711 collected (1200)
Seat 3: Tallir folded before Flop (didn't bet)
Seat 4: didyk59 folded before Flop (didn't bet)
Seat 6: stalin191137 (button) folded before Flop (didn't bet)
Seat 7: Rx_Kings (small blind) folded before Flop
Seat 8: Rosa885 (big blind) folded before Flop
Seat 9: Asildar folded before Flop (didn't bet)



PokerStars Hand #245426114835: Tournament #3632163743, $0.23+$0.02 USD Hold'em No Limit - Level IX (200/400) - 2023/08/16 15:37:55 AT [2023/08/16 14:37:55 ET]
Table '3632163743 5' 9-max Seat #7 is the button
Seat 1: Caio Mugarte (4781 in chips) 
Seat 2: banane4711 (9229 in chips) 
Seat 3: Tallir (2250 in chips) 
Seat 4: didyk59 (3795 in chips) 
Seat 6: stalin191137 (3797 in chips) 
Seat 7: Rx_Kings (9567 in chips) 
Seat 8: Rosa885 (10515 in chips) 
Seat 9: Asildar (23566 in chips) 
Caio Mugarte: posts the ante 25
banane4711: posts the ante 25
Tallir: posts the ante 25
didyk59: posts the ante 25
stalin191137: posts the ante 25
Rx_Kings: posts the ante 25
Rosa885: posts the ante 25
Asildar: posts the ante 25
Rosa885: posts small blind 200
Asildar: posts big blind 400
*** HOLE CARDS ***
Dealt to Caio Mugarte [Kc 5c]
Caio Mugarte: folds 
banane4711: folds 
Tallir: folds 
didyk59: folds 
stalin191137: raises 3372 to 3772 and is all-in
Rx_Kings: folds 
Rosa885: folds 
Asildar: folds 
Uncalled bet (3372) returned to stalin191137
stalin191137 collected 1200 from pot
stalin191137: doesn't show hand 
*** SUMMARY ***
Total pot 1200 | Rake 0 
Seat 1: Caio Mugarte folded before Flop (didn't bet)
Seat 2: banane4711 folded before Flop (didn't bet)
Seat 3: Tallir folded before Flop (didn't bet)
Seat 4: didyk59 folded before Flop (didn't bet)
Seat 6: stalin191137 collected (1200)
Seat 7: Rx_Kings (button) folded before Flop (didn't bet)
Seat 8: Rosa885 (small blind) folded before Flop
Seat 9: Asildar (big blind) folded before Flop



PokerStars Hand #245426122667: Tournament #3632163743, $0.23+$0.02 USD Hold'em No Limit - Level IX (200/400) - 2023/08/16 15:38:21 AT [2023/08/16 14:38:21 ET]
Table '3632163743 5' 9-max Seat #8 is the button
Seat 1: Caio Mugarte (4756 in chips) 
Seat 2: banane4711 (9204 in chips) 
Seat 3: Tallir (2225 in chips) 
Seat 4: didyk59 (3770 in chips) 
Seat 6: stalin191137 (4572 in chips) 
Seat 7: Rx_Kings (9542 in chips) 
Seat 8: Rosa885 (10290 in chips) 
Seat 9: Asildar (23141 in chips) 
Caio Mugarte: posts the ante 25
banane4711: posts the ante 25
Tallir: posts the ante 25
didyk59: posts the ante 25
stalin191137: posts the ante 25
Rx_Kings: posts the ante 25
Rosa885: posts the ante 25
Asildar: posts the ante 25
Asildar: posts small blind 200
Caio Mugarte: posts big blind 400
*** HOLE CARDS ***
Dealt to Caio Mugarte [4c 2h]
banane4711: folds 
Tallir: raises 1800 to 2200 and is all-in
didyk59: folds 
stalin191137: folds 
Rx_Kings: folds 
Rosa885: folds 
Asildar: folds 
Caio Mugarte: folds 
Uncalled bet (1800) returned to Tallir
Tallir collected 1200 from pot
*** SUMMARY ***
Total pot 1200 | Rake 0 
Seat 1: Caio Mugarte (big blind) folded before Flop
Seat 2: banane4711 folded before Flop (didn't bet)
Seat 3: Tallir collected (1200)
Seat 4: didyk59 folded before Flop (didn't bet)
Seat 6: stalin191137 folded before Flop (didn't bet)
Seat 7: Rx_Kings folded before Flop (didn't bet)
Seat 8: Rosa885 (button) folded before Flop (didn't bet)
Seat 9: Asildar (small blind) folded before Flop



PokerStars Hand #245426130636: Tournament #3632163743, $0.23+$0.02 USD Hold'em No Limit - Level IX (200/400) - 2023/08/16 15:38:47 AT [2023/08/16 14:38:47 ET]
Table '3632163743 5' 9-max Seat #9 is the button
Seat 1: Caio Mugarte (4331 in chips) 
Seat 2: banane4711 (9179 in chips) 
Seat 3: Tallir (3000 in chips) 
Seat 4: didyk59 (3745 in chips) 
Seat 6: stalin191137 (4547 in chips) 
Seat 7: Rx_Kings (9517 in chips) 
Seat 8: Rosa885 (10265 in chips) 
Seat 9: Asildar (22916 in chips) 
Caio Mugarte: posts the ante 25
banane4711: posts the ante 25
Tallir: posts the ante 25
didyk59: posts the ante 25
stalin191137: posts the ante 25
Rx_Kings: posts the ante 25
Rosa885: posts the ante 25
Asildar: posts the ante 25
Caio Mugarte: posts small blind 200
banane4711: posts big blind 400
*** HOLE CARDS ***
Dealt to Caio Mugarte [2d Ah]
Tallir: folds 
didyk59: folds 
stalin191137: raises 800 to 1200
Rx_Kings: folds 
Rosa885: folds 
Asildar: folds 
Caio Mugarte: folds 
banane4711: folds 
Uncalled bet (800) returned to stalin191137
stalin191137 collected 1200 from pot
stalin191137: doesn't show hand 
*** SUMMARY ***
Total pot 1200 | Rake 0 
Seat 1: Caio Mugarte (small blind) folded before Flop
Seat 2: banane4711 (big blind) folded before Flop
Seat 3: Tallir folded before Flop (didn't bet)
Seat 4: didyk59 folded before Flop (didn't bet)
Seat 6: stalin191137 collected (1200)
Seat 7: Rx_Kings folded before Flop (didn't bet)
Seat 8: Rosa885 folded before Flop (didn't bet)
Seat 9: Asildar (button) folded before Flop (didn't bet)



PokerStars Hand #245426140137: Tournament #3632163743, $0.23+$0.02 USD Hold'em No Limit - Level IX (200/400) - 2023/08/16 15:39:18 AT [2023/08/16 14:39:18 ET]
Table '3632163743 5' 9-max Seat #1 is the button
Seat 1: Caio Mugarte (4106 in chips) 
Seat 2: banane4711 (8754 in chips) 
Seat 3: Tallir (2975 in chips) 
Seat 4: didyk59 (3720 in chips) 
Seat 6: stalin191137 (5322 in chips) 
Seat 7: Rx_Kings (9492 in chips) 
Seat 8: Rosa885 (10240 in chips) 
Seat 9: Asildar (22891 in chips) 
Caio Mugarte: posts the ante 25
banane4711: posts the ante 25
Tallir: posts the ante 25
didyk59: posts the ante 25
stalin191137: posts the ante 25
Rx_Kings: posts the ante 25
Rosa885: posts the ante 25
Asildar: posts the ante 25
banane4711: posts small blind 200
Tallir: posts big blind 400
*** HOLE CARDS ***
Dealt to Caio Mugarte [7c 5d]
didyk59: folds 
stalin191137: folds 
Rx_Kings: folds 
Rosa885: folds 
Asildar: folds 
Caio Mugarte: folds 
banane4711: folds 
Uncalled bet (200) returned to Tallir
Tallir collected 600 from pot
*** SUMMARY ***
Total pot 600 | Rake 0 
Seat 1: Caio Mugarte (button) folded before Flop (didn't bet)
Seat 2: banane4711 (small blind) folded before Flop
Seat 3: Tallir (big blind) collected (600)
Seat 4: didyk59 folded before Flop (didn't bet)
Seat 6: stalin191137 folded before Flop (didn't bet)
Seat 7: Rx_Kings folded before Flop (didn't bet)
Seat 8: Rosa885 folded before Flop (didn't bet)
Seat 9: Asildar folded before Flop (didn't bet)



PokerStars Hand #245426145626: Tournament #3632163743, $0.23+$0.02 USD Hold'em No Limit - Level IX (200/400) - 2023/08/16 15:39:36 AT [2023/08/16 14:39:36 ET]
Table '3632163743 5' 9-max Seat #2 is the button
Seat 1: Caio Mugarte (4081 in chips) 
Seat 2: banane4711 (8529 in chips) 
Seat 3: Tallir (3350 in chips) 
Seat 4: didyk59 (3695 in chips) 
Seat 6: stalin191137 (5297 in chips) 
Seat 7: Rx_Kings (9467 in chips) 
Seat 8: Rosa885 (10215 in chips) 
Seat 9: Asildar (22866 in chips) 
Caio Mugarte: posts the ante 25
banane4711: posts the ante 25
Tallir: posts the ante 25
didyk59: posts the ante 25
stalin191137: posts the ante 25
Rx_Kings: posts the ante 25
Rosa885: posts the ante 25
Asildar: posts the ante 25
Tallir: posts small blind 200
didyk59: posts big blind 400
*** HOLE CARDS ***
Dealt to Caio Mugarte [Ah 2h]
stalin191137: folds 
Rx_Kings: folds 
Rosa885: folds 
Asildar: raises 400 to 800
Caio Mugarte: folds 
banane4711: folds 
Tallir: folds 
didyk59: folds 
Uncalled bet (400) returned to Asildar
Asildar collected 1200 from pot
Asildar: doesn't show hand 
*** SUMMARY ***
Total pot 1200 | Rake 0 
Seat 1: Caio Mugarte folded before Flop (didn't bet)
Seat 2: banane4711 (button) folded before Flop (didn't bet)
Seat 3: Tallir (small blind) folded before Flop
Seat 4: didyk59 (big blind) folded before Flop
Seat 6: stalin191137 folded before Flop (didn't bet)
Seat 7: Rx_Kings folded before Flop (didn't bet)
Seat 8: Rosa885 folded before Flop (didn't bet)
Seat 9: Asildar collected (1200)



PokerStars Hand #245426155862: Tournament #3632163743, $0.23+$0.02 USD Hold'em No Limit - Level IX (200/400) - 2023/08/16 15:40:09 AT [2023/08/16 14:40:09 ET]
Table '3632163743 5' 9-max Seat #3 is the button
Seat 1: Caio Mugarte (4056 in chips) 
Seat 2: banane4711 (8504 in chips) 
Seat 3: Tallir (3125 in chips) 
Seat 4: didyk59 (3270 in chips) 
Seat 6: stalin191137 (5272 in chips) 
Seat 7: Rx_Kings (9442 in chips) 
Seat 8: Rosa885 (10190 in chips) 
Seat 9: Asildar (23641 in chips) 
Caio Mugarte: posts the ante 25
banane4711: posts the ante 25
Tallir: posts the ante 25
didyk59: posts the ante 25
stalin191137: posts the ante 25
Rx_Kings: posts the ante 25
Rosa885: posts the ante 25
Asildar: posts the ante 25
didyk59: posts small blind 200
stalin191137: posts big blind 400
*** HOLE CARDS ***
Dealt to Caio Mugarte [3d 2s]
Rx_Kings: folds 
Rosa885: calls 400
Asildar: folds 
Caio Mugarte: folds 
banane4711: folds 
Tallir: folds 
didyk59: raises 2845 to 3245 and is all-in
stalin191137: folds 
Rosa885: folds 
Uncalled bet (2845) returned to didyk59
didyk59 collected 1400 from pot
didyk59: doesn't show hand 
*** SUMMARY ***
Total pot 1400 | Rake 0 
Seat 1: Caio Mugarte folded before Flop (didn't bet)
Seat 2: banane4711 folded before Flop (didn't bet)
Seat 3: Tallir (button) folded before Flop (didn't bet)
Seat 4: didyk59 (small blind) collected (1400)
Seat 6: stalin191137 (big blind) folded before Flop
Seat 7: Rx_Kings folded before Flop (didn't bet)
Seat 8: Rosa885 folded before Flop
Seat 9: Asildar folded before Flop (didn't bet)



PokerStars Hand #245426169632: Tournament #3632163743, $0.23+$0.02 USD Hold'em No Limit - Level IX (200/400) - 2023/08/16 15:40:55 AT [2023/08/16 14:40:55 ET]
Table '3632163743 5' 9-max Seat #4 is the button
Seat 1: Caio Mugarte (4031 in chips) 
Seat 2: banane4711 (8479 in chips) 
Seat 3: Tallir (3100 in chips) 
Seat 4: didyk59 (4245 in chips) 
Seat 6: stalin191137 (4847 in chips) 
Seat 7: Rx_Kings (9417 in chips) 
Seat 8: Rosa885 (9765 in chips) 
Seat 9: Asildar (23616 in chips) 
Caio Mugarte: posts the ante 25
banane4711: posts the ante 25
Tallir: posts the ante 25
didyk59: posts the ante 25
stalin191137: posts the ante 25
Rx_Kings: posts the ante 25
Rosa885: posts the ante 25
Asildar: posts the ante 25
stalin191137: posts small blind 200
Rx_Kings: posts big blind 400
*** HOLE CARDS ***
Dealt to Caio Mugarte [9h 3h]
Rosa885: folds 
Asildar: folds 
Caio Mugarte: folds 
banane4711: folds 
Tallir: raises 2675 to 3075 and is all-in
didyk59: folds 
stalin191137: folds 
Rx_Kings: folds 
Uncalled bet (2675) returned to Tallir
Tallir collected 1200 from pot
*** SUMMARY ***
Total pot 1200 | Rake 0 
Seat 1: Caio Mugarte folded before Flop (didn't bet)
Seat 2: banane4711 folded before Flop (didn't bet)
Seat 3: Tallir collected (1200)
Seat 4: didyk59 (button) folded before Flop (didn't bet)
Seat 6: stalin191137 (small blind) folded before Flop
Seat 7: Rx_Kings (big blind) folded before Flop
Seat 8: Rosa885 folded before Flop (didn't bet)
Seat 9: Asildar folded before Flop (didn't bet)



PokerStars Hand #245426179307: Tournament #3632163743, $0.23+$0.02 USD Hold'em No Limit - Level IX (200/400) - 2023/08/16 15:41:26 AT [2023/08/16 14:41:26 ET]
Table '3632163743 5' 9-max Seat #6 is the button
Seat 1: Caio Mugarte (4006 in chips) 
Seat 2: banane4711 (8454 in chips) 
Seat 3: Tallir (3875 in chips) 
Seat 4: didyk59 (4220 in chips) 
Seat 6: stalin191137 (4622 in chips) 
Seat 7: Rx_Kings (8992 in chips) 
Seat 8: Rosa885 (9740 in chips) 
Seat 9: Asildar (23591 in chips) 
Caio Mugarte: posts the ante 25
banane4711: posts the ante 25
Tallir: posts the ante 25
didyk59: posts the ante 25
stalin191137: posts the ante 25
Rx_Kings: posts the ante 25
Rosa885: posts the ante 25
Asildar: posts the ante 25
Rx_Kings: posts small blind 200
Rosa885: posts big blind 400
*** HOLE CARDS ***
Dealt to Caio Mugarte [Jh 5d]
Asildar: folds 
Caio Mugarte: folds 
banane4711: folds 
Tallir: folds 
didyk59: folds 
stalin191137: raises 4197 to 4597 and is all-in
Rx_Kings: folds 
Rosa885: folds 
Uncalled bet (4197) returned to stalin191137
stalin191137 collected 1200 from pot
stalin191137: doesn't show hand 
*** SUMMARY ***
Total pot 1200 | Rake 0 
Seat 1: Caio Mugarte folded before Flop (didn't bet)
Seat 2: banane4711 folded before Flop (didn't bet)
Seat 3: Tallir folded before Flop (didn't bet)
Seat 4: didyk59 folded before Flop (didn't bet)
Seat 6: stalin191137 (button) collected (1200)
Seat 7: Rx_Kings (small blind) folded before Flop
Seat 8: Rosa885 (big blind) folded before Flop
Seat 9: Asildar folded before Flop (didn't bet)



PokerStars Hand #245426188172: Tournament #3632163743, $0.23+$0.02 USD Hold'em No Limit - Level IX (200/400) - 2023/08/16 15:41:55 AT [2023/08/16 14:41:55 ET]
Table '3632163743 5' 9-max Seat #7 is the button
Seat 1: Caio Mugarte (3981 in chips) 
Seat 2: banane4711 (8429 in chips) 
Seat 3: Tallir (3850 in chips) 
Seat 4: didyk59 (4195 in chips) 
Seat 6: stalin191137 (5397 in chips) 
Seat 7: Rx_Kings (8767 in chips) 
Seat 8: Rosa885 (9315 in chips) 
Seat 9: Asildar (23566 in chips) 
Caio Mugarte: posts the ante 25
banane4711: posts the ante 25
Tallir: posts the ante 25
didyk59: posts the ante 25
stalin191137: posts the ante 25
Rx_Kings: posts the ante 25
Rosa885: posts the ante 25
Asildar: posts the ante 25
Rosa885: posts small blind 200
Asildar: posts big blind 400
*** HOLE CARDS ***
Dealt to Caio Mugarte [9h Td]
Caio Mugarte: folds 
banane4711: folds 
Tallir: folds 
didyk59: folds 
stalin191137: folds 
Rx_Kings: folds 
Rosa885: calls 200
Asildar: checks 
*** FLOP *** [Qh 8h 7h]
Rosa885: checks 
Asildar: checks 
*** TURN *** [Qh 8h 7h] [4c]
Rosa885: checks 
Asildar: bets 736
Rosa885: calls 736
*** RIVER *** [Qh 8h 7h 4c] [Qc]
Rosa885: bets 2200
Asildar: folds 
Uncalled bet (2200) returned to Rosa885
Rosa885 collected 2472 from pot
*** SUMMARY ***
Total pot 2472 | Rake 0 
Board [Qh 8h 7h 4c Qc]
Seat 1: Caio Mugarte folded before Flop (didn't bet)
Seat 2: banane4711 folded before Flop (didn't bet)
Seat 3: Tallir folded before Flop (didn't bet)
Seat 4: didyk59 folded before Flop (didn't bet)
Seat 6: stalin191137 folded before Flop (didn't bet)
Seat 7: Rx_Kings (button) folded before Flop (didn't bet)
Seat 8: Rosa885 (small blind) collected (2472)
Seat 9: Asildar (big blind) folded on the River



PokerStars Hand #245426208869: Tournament #3632163743, $0.23+$0.02 USD Hold'em No Limit - Level IX (200/400) - 2023/08/16 15:43:02 AT [2023/08/16 14:43:02 ET]
Table '3632163743 5' 9-max Seat #8 is the button
Seat 1: Caio Mugarte (3956 in chips) 
Seat 2: banane4711 (8404 in chips) 
Seat 3: Tallir (3825 in chips) 
Seat 4: didyk59 (4170 in chips) 
Seat 6: stalin191137 (5372 in chips) 
Seat 7: Rx_Kings (8742 in chips) 
Seat 8: Rosa885 (10626 in chips) 
Seat 9: Asildar (22405 in chips) 
Caio Mugarte: posts the ante 25
banane4711: posts the ante 25
Tallir: posts the ante 25
didyk59: posts the ante 25
stalin191137: posts the ante 25
Rx_Kings: posts the ante 25
Rosa885: posts the ante 25
Asildar: posts the ante 25
Asildar: posts small blind 200
Caio Mugarte: posts big blind 400
*** HOLE CARDS ***
Dealt to Caio Mugarte [Td 3c]
banane4711: folds 
Tallir: folds 
didyk59: folds 
stalin191137: folds 
Rx_Kings: folds 
Rosa885: folds 
Asildar: raises 4400 to 4800
Caio Mugarte: folds 
Uncalled bet (4400) returned to Asildar
Asildar collected 1000 from pot
Asildar: doesn't show hand 
*** SUMMARY ***
Total pot 1000 | Rake 0 
Seat 1: Caio Mugarte (big blind) folded before Flop
Seat 2: banane4711 folded before Flop (didn't bet)
Seat 3: Tallir folded before Flop (didn't bet)
Seat 4: didyk59 folded before Flop (didn't bet)
Seat 6: stalin191137 folded before Flop (didn't bet)
Seat 7: Rx_Kings folded before Flop (didn't bet)
Seat 8: Rosa885 (button) folded before Flop (didn't bet)
Seat 9: Asildar (small blind) collected (1000)



PokerStars Hand #245426217311: Tournament #3632163743, $0.23+$0.02 USD Hold'em No Limit - Level IX (200/400) - 2023/08/16 15:43:30 AT [2023/08/16 14:43:30 ET]
Table '3632163743 5' 9-max Seat #9 is the button
Seat 1: Caio Mugarte (3531 in chips) 
Seat 2: banane4711 (8379 in chips) 
Seat 3: Tallir (3800 in chips) 
Seat 4: didyk59 (4145 in chips) 
Seat 6: stalin191137 (5347 in chips) 
Seat 7: Rx_Kings (8717 in chips) 
Seat 8: Rosa885 (10601 in chips) 
Seat 9: Asildar (22980 in chips) 
Caio Mugarte: posts the ante 25
banane4711: posts the ante 25
Tallir: posts the ante 25
didyk59: posts the ante 25
stalin191137: posts the ante 25
Rx_Kings: posts the ante 25
Rosa885: posts the ante 25
Asildar: posts the ante 25
Caio Mugarte: posts small blind 200
banane4711: posts big blind 400
*** HOLE CARDS ***
Dealt to Caio Mugarte [7d 8h]
Tallir: folds 
didyk59: folds 
stalin191137: folds 
Rx_Kings: folds 
Rosa885: folds 
Asildar: raises 400 to 800
Caio Mugarte: folds 
banane4711: raises 7554 to 8354 and is all-in
Asildar: folds 
Uncalled bet (7554) returned to banane4711
banane4711 collected 2000 from pot
banane4711: doesn't show hand 
*** SUMMARY ***
Total pot 2000 | Rake 0 
Seat 1: Caio Mugarte (small blind) folded before Flop
Seat 2: banane4711 (big blind) collected (2000)
Seat 3: Tallir folded before Flop (didn't bet)
Seat 4: didyk59 folded before Flop (didn't bet)
Seat 6: stalin191137 folded before Flop (didn't bet)
Seat 7: Rx_Kings folded before Flop (didn't bet)
Seat 8: Rosa885 folded before Flop (didn't bet)
Seat 9: Asildar (button) folded before Flop



PokerStars Hand #245426226919: Tournament #3632163743, $0.23+$0.02 USD Hold'em No Limit - Level IX (200/400) - 2023/08/16 15:44:01 AT [2023/08/16 14:44:01 ET]
Table '3632163743 5' 9-max Seat #1 is the button
Seat 1: Caio Mugarte (3306 in chips) 
Seat 2: banane4711 (9554 in chips) 
Seat 3: Tallir (3775 in chips) 
Seat 4: didyk59 (4120 in chips) 
Seat 6: stalin191137 (5322 in chips) 
Seat 7: Rx_Kings (8692 in chips) 
Seat 8: Rosa885 (10576 in chips) 
Seat 9: Asildar (22155 in chips) 
Caio Mugarte: posts the ante 25
banane4711: posts the ante 25
Tallir: posts the ante 25
didyk59: posts the ante 25
stalin191137: posts the ante 25
Rx_Kings: posts the ante 25
Rosa885: posts the ante 25
Asildar: posts the ante 25
banane4711: posts small blind 200
Tallir: posts big blind 400
*** HOLE CARDS ***
Dealt to Caio Mugarte [9c 9h]
didyk59: folds 
stalin191137: raises 4897 to 5297 and is all-in
Rx_Kings: folds 
Rosa885: folds 
Asildar: folds 
Caio Mugarte: calls 3281 and is all-in
banane4711: folds 
Tallir: folds 
Uncalled bet (2016) returned to stalin191137
*** FLOP *** [8c Ks 5d]
*** TURN *** [8c Ks 5d] [7c]
*** RIVER *** [8c Ks 5d 7c] [4d]
*** SHOW DOWN ***
stalin191137: shows [Jc Js] (a pair of Jacks)
Caio Mugarte: shows [9c 9h] (a pair of Nines)
stalin191137 collected 7362 from pot
Caio Mugarte finished the tournament in 8th place
*** SUMMARY ***
Total pot 7362 | Rake 0 
Board [8c Ks 5d 7c 4d]
Seat 1: Caio Mugarte (button) showed [9c 9h] and lost with a pair of Nines
Seat 2: banane4711 (small blind) folded before Flop
Seat 3: Tallir (big blind) folded before Flop
Seat 4: didyk59 folded before Flop (didn't bet)
Seat 6: stalin191137 showed [Jc Js] and won (7362) with a pair of Jacks
Seat 7: Rx_Kings folded before Flop (didn't bet)
Seat 8: Rosa885 folded before Flop (didn't bet)
Seat 9: Asildar folded before Flop (didn't bet)



